TEXT	TRANSLATION
(0.0 < x < 1.0)	
(Selected)	(Selektiert)
(Tw) wetness decline time constant	
(Tw) wetness decline time constant [lower bound]	
(Tw) wetness decline time constant [upper bound]	
(a)	
(a) [lower bound]	
(a) [upper bound]	
(b)	
(b) [lower bound]	
(b) [upper bound]	
(c) Parameter [lower bound]	
(c) Parameter [upper bound]	
(f) Temperature Modulation Factor [lower bound]	
(f) Temperature Modulation Factor [upper bound]	
(optional) Linear Flow Threshold Grid	
)	
*	
** Error : Wrong outlet point selected **	
** Warning : Number of events might not be representative.\nMinimum number recommended: 	
** Warning : Outlet point was modified **	
,	
--- no table available ---	
--- not available ---	
0	
0 - 1	
0 - 1.0	
0 - 255	
0 is horizontal, 90 is vertical.	
0.1	
01: A Simple Litter System	
01: My first module	
02: Carbon Cycle Simulation for Terrestrial Biomes	
02: Pixel by pixel operations with two grids	
03: Direct neighbours	
03: Spatially Distributed Simulation of Soil Nitrogen Dynamics	
04: Direct neighbours - more...	
05: Direct neighbours - slope and aspect	
06: Extended neighbourhoods	
07: Extended neighbourhoods - catchment areas (trace flow)	
08: Extended neighbourhoods - catchment areas (parallel)	
09: Extended neighbourhoods - catchment areas (recursive)	
1	
1 / cell size (specific catchment area)	
1 arc-second	
1 bit	
1 byte integer	1 Byte Ganzzahl
1 byte signed integer	1 Byte Ganzzahl mit Vorzeichen
1 byte unsigned integer	1 Byte Ganzzahl ohne Vorzeichen
1.0	
1.5 * Standard Deviation	1,5 * Standardabweichung
10: Dynamic Simulation - Life	
11: Dynamic Simulation - Soil Nitrogen Dynamics	
12: First steps with shapes	
13: Reprojecting a shapes layer	
14: Vectorising channel lines	
16 bit signed integer	
16 bit unsigned integer	
1st Std. Parallel	
2	
2 byte integer	2 Byte Ganzzahl
2 byte integer|4 byte floating point|	
2 byte signed integer	2 Byte Ganzzahl mit Vorzeichen
2 byte unsigned integer	2 Byte Ganzzahl ohne Vorzeichen
2.0	
2.0 * Standard Deviation	2,0 * Standardabweichung
20 seconds	20 Sekunden
2nd Std. Parallel	
3	
3 X 3	
3 arc-second	
3 parameters (translation only)	
32 bit floating point	
32 bit signed integer	
32 bit unsigned integer	
3306	
3D Image	3D Bild
3D Image Height	3D Bild Höhe
3D Image Width	3D Bild Breite
3D View	3D Ansicht
4 (von Neumann)	
4 byte float	
4 byte floating point	4 Byte Fließkommazahl
4 byte floating point number	4 Byte Fließkommanummer
4 byte integer	4 Byte Ganzzahl
4 byte signed integer	4 Byte Ganzzahl mit Vorzeichen
4 byte unsigned integer	4 Byte Ganzzahl ohne Vorzeichen
5 X 5	
64 bit floating point	
7 X 7	
7 parameters	
8 (Moore)	
8 bit unsigned integer	
8 byte float	
8 byte floating point	8 Byte Fließkommazahl
8 byte floating point number	8 Byte Fließkommazahl
:-( :-( you are a loser :-( :-(	
:-) :-) you are a winner :-) :-) Time:%ds\n	
;	
<	
<=	
=	
>	
>=	
A	
A / tan(\xc3\x9f)	
A SAGA module to create transects through polygon files.	
A Simple Litter System	
A grid that contains elevation data.	
A set of basic SAGA module programming lectures.	
A3 Landscape	A3 Querformat
A3 Portrait	A3 Hochformat
A4 Landscape	A4 Querformat
A4 Portrait	A4 Hochformat
A:Geostatistics|Points	
A:Grid|Construction	A:Raster|Konstruktion
A:Shapes|Construction	A:Vektoren|Konstruktion
ADDR	
AFAC(	
AFAC()	
AOI Shape	AOI Vektor (Automatische Optische Inspektion)
AQ(	
AREA	FLÄCHE
AS(	
ASCII	
ASCII Decimal Separator	
ASCII Grid Options	
ASCII Precision	
AWM1 Grid	
AWM2 Grid	
AWT Grid	
AZIMUTH	
About SAGA	Über SAGA
Above Elevation	
Above this threshold snow will start to melt	
Absolute	Absolut
Absolute Area	
Absolute Height	
Absolute Water Level	
Absolute Water Levels	
Acc. Area	
Accumulated Cost	Akkumulierte Kosten
Accumulated Cost (Anisotropic)	Akkumulierte Kosten (Anisotropisch)
Accumulated Cost (Isotropic)	Akkumulierte Kosten (Isotropisch)
Accumulated Material from _left_ side	
Accumulated Material from _right_ side	
Accumulated cost	Akkumulierte Kosten
Accumulated cost surface	
Acknowledgements	Danksagungen
Activate Grid File Cache?	Dateipuffer für Raster aktivieren?
Activate file caching automatically, if memory size exceeds the threshold value.	Dateipuffer für Raster automatisch aktivieren, wenn Speicherbedarf Schwellenwert überschreitet.
Add Attribute to Clipped Points	Füge Attribute zu ausgeschnittenen Punkten hinzu
Add Border	Füge Grenze hinzu
Add Cells	
Add Coordinates to points	Füge Koordinaten zu Punkten hinzu
Add Field	Feld hinzufügen
Add Frame	Füge Rahmen hinzu
Add Grid Values to Points	Weise Rasterwerte Punkten zu
Add Link to Files	Erzeuge Verknüpfung zu Dateien
Add Polygon Attributes to Points	Füge Polygonattribute Punkten hinzu
Add Volumes Below Base Level	Füge Volumnia unter Ausgangsniveau hinzu
Add to current selection	Füge zu aktueller Auswahl hinzu
Addition	
Additional Cuts	zusätzliche Schnitte
Additional Grids	zusätzliche Raster
Additional Layers	Zusätzliche Ebenen
Additional Parameters	
Additional Values	zusätzliche Werte
Additional values that shall be saved to the output table.	
Addition|	
Adjust	Einstellen
Adjust to Grid	
Advanced Settings	fortgeschrittene Einstellungen
Aggregate	Anhäufung
Aggregation	Vereinigung
Aggregation Index	Zusammenführungsindex
Aggregation Size	Anhäufung Größe
Air Humidity (2pm) [%%]	
Air Pressure, Water and Dust Content	
Albers Equal Area Conic	
Alessandro Perego	
Algorithm for the detection of Surface Specific Points	
All	
All Files	Alle Dateien
All Files|*.*|	
All Recognised Files	Alle erkannten Dateitypen
All Recognized File Types	
All Recognized Files	
Allocation	Zuweisung
Allocation Grid	Zuweisungsraster
Allow longitudes outside -180 to 180 Range	
Allows to write cell values from additional grids to the output	
Alpha Max (Degree)	
Altitude above Channel Network	
Altura de llama	
Altura de llama (m)	
Anaglyph	
Analytical Hierarchy Process	Analytischer hierarchischer Prozess
Analytical Hillshading	
Analytical hillshading calculation.	
Anchor Point	Ankerpunkt
Angle	Winkel
Angle (in degrees)	
Angle [Degree]	
Angle in degrees, counting clockwise from north	Winkel in Grad, Zählung im Uhrzeigersinn von Nord
Angle. In radians	Winkel. In Radiant
Applies also to the binary format header file.	
Apply Move	
Apply offset?	Versatz zufügen?
Approx. Terrain Slope	ungefähre Geländeneigung
Approximate Terrain Slope [%]	ungefähre Geländeneigung [%]
April	
Arcs	
Arcs to polygons	
Are completely within	Vektordaten eine Tabelle zuweisen
Area	Fläche
Area (ha)	
Area +	
Area -	
Area [km2]	
Area [km2] Subbasin(	
Area of the Watershed in [km2]	
Area of the Watershed in [km2] used for unit conversion	
Area to Length Conversion	
Area[%]	Fläche[%]
Areal average of ln(T0) = ln(Te) [ln(m^2/h)]	
Arithmetic Mean	arithmetrisches Mittel
Arithmetic mean (version 1)	
Arithmetic mean (version 2)	
Aspect	
Aspect grid, in radians.	
Assign	Zuweisen
Assign attributes to shapes...	
At least two polygons have to be given for intersection	Mindestens zwei Polygone sind für Schnittmenge anzugeben
At the moment the reclass table is limited to 128 categories!\n	Zur Zeit ist die Reklassifizierungstabelle auf 128 Kategorien beschränkt!\n
Atlas Boundary Files (*.bna)|*.bna|All Files|*.*	
Atmospheric Effects	
Atmospheric Pressure [mbar]	
Attribute	Attribut
Attribute A	
Attribute B	
Attribute Field Properties	
Attribute Fields	
Attribute Table	Attributtabelle
Attribute is Column ...	
Attribute to add. Select none to add all	Anzufügende Attribute. Wähle none um alle anzufügen
Attribute to drop	Attribute zum Fallenlassen
Attribute to drop.	Attribute zum Fallenlassen
Attribute to process.	Attribute zum Bearbeiten
Attributes	Attribute
Attributes to import besides x,y,z ...	
August	
Automatic mode	Automatisch
Automatically adjust control points to grid's data range	
Automatically fits the grid to the shapes layers extent.	
Automatically normalise attributes by standard deviation before clustering.	
Automatically normalise grids by standard deviation before clustering.	Automatisches normalisieren der raster mit Standardabweichung vor der Clusterbildung.
Available Choices	Auswahlmöglichkeiten
Available Connections	Auswahlverbindungen
Available Projections:	
Average	Durchschnitt
Average 2 With Thereshold for Grids calculates average in X and Y distances unsing only the values that differ form central pixel less than a specified threshold. Each value has a weight which is inversely proportional to the distance (method 1).	
Average 3 With Thereshold for Grids calculates average in X and Y distances unsing only the values that differ form central pixel less than a specified threshold. Each value has a weight which is inversely proportional to the distance (method 2).	
Average With Mask 1	
Average With Mask 1 calculates average for cells specified by a mask grid. Cell excluded by the mask grid are NOT used in the average calculation.	
Average With Mask 2	
Average With Mask 2 calculates average for cells specified by a mask grid. However cell excluded by the mask grid are used in the average calculation for right pixels.	
Average With Thereshold 1	
Average With Thereshold 2	
Average With Thereshold 3	
Average With Thereshold for Grids calculates average in X and Y distances unsing only the values that differ form central pixel less than a specified threshold. It's useful to remove noise whit a known maximum reducing the loss of informations	
Avg. Curve Number	
Avg. Manning's N	
Avg. Rainfall Intensity (mm/h)	
Azimuth	
Azimuth [Degree]	
Azimuth []	
Azimuthal Equidistant	
B	
B-Spline Approximation	B-Spline-Angleichung
B-Spline Interpolation	
BFAC(	
BLACK_BLUE	
BLACK_GREEN	
BLACK_RED	
BLACK_WHITE	
BQ(	
BSL	
BSL Files (*.bsl)	BSL Dateien (*.bsl)
BSL Script	
BSL from File	BSL aus Datei
Background Color	Hintergrundfarbe
Backward diagonal hatch	Diagonal rückwarts schraffiert
Band	
Bands	
Bandwidth (Cells)	
Bare Earth	kahle Erde
Bars	Balken
Base Grid	Basisraster
Base Level	Ausgangsniveau
Base Probability	
Basic Morphometry	
Basic measures for spatial point patterns.	
Basin Code	
Basin Type (Gravelius)	
Basin subdivision	
Below this threshold precipitation will fall as snow	
Bicubic Spline Interpolation	Bikubische Spline Interpolation
Bifurcation	
Big Endian (Motorola)	
Bilinear Interpolation	Bilineare Interpolation
Binary Byte Order	
Binary Encoding	binäres Verschlüsseln
Birth Rate of Fishes	
Birth Rate of Sharks	
Block Kriging	
Block Size	
Blocks	
Blue	Blau
Board	
Boehner & Selige 2006	
Boehner's Simple Language (BSL) is a macro script language for grid based calculations.	Boehner`s Simple Language (BSL) ist eine Macroscriptsprache für rasterbasierte Berechnungen.
Bonne	
Borders	Grenzen
Bottom	Basis
Bottom to Top	
Boundaries	Grenzen
Boundary	
Bounding Box	
Branches	
Branches to Litter	
Braunschweiger Reliefmodell	
Breaks	
Buffer	Puffer
Buffer Distance	Pufferdistanz
Buffer Distance (Attribute)	Pufferdistanz (Attribut)
Buffer Distance (Fixed)	Pufferdistanz (fest)
Buffer Grid	Pufferraster
Buffer Size [MB]	Puffergröße [MB]
Buffer distance	Pufferdistanz
Buffer distance (grid units).	Pufferdistanz (Rastereinheiten).
By number	durch Nummer
Byte Order	
Byte order when writing floating point values in binary format	
C	
C Correction	
C Factor	
CELLS	ZELLEN
CENTER	MITTE
CFAC(	
CFit\n(created by SAGA Wizard).	CPassend\n(durch SAGA Wizard erzeugt).
CLASS	KLASSE
CLUSTER	
COLOR	FARBE
CONTIGUITY	
COUNT	ANZAHL
CRS Database	
CRS Dictionary	
CSV Files (*.csv)	
Calculate distribution Quantiles	Kalkuliere das Wahrscheinlichkeitsquantil
Calculate the volume under the grid's surface. This is mainly useful for Digital Elevation Models (DEM).	Kalkuliere das Volumen unter der Rasteroberfläche. Dieses ist hauptsächlich sinnvoll für Digitale Geländemodelle (DGM).
Calculates the gradient based on the values of each triangle's points.\n\n	Berechnet den Gradient basierend auf dem Wert eines jeden Dreieckspunktes.\n\n
Calculates weights for distance plus one, avoiding division by zero for zero distances	
Calculating Catchment Area...	
Calculating Subbasins...	
Calculating danger...	
Calculation	
Cancel	
Canny	
Carbon Cycle Simulation	
Carbonization Factor	
Case Sensitive	
Case of contiguity	
Cassini	
Catchment Area	
Catchment Aspect	
Catchment Height	
Catchment Slope	
Catchment area	
Catchment area calculation...	
Catchment slope	
Categorial Grids	
Cell Balance	
Cell Count	Zellen Anzahl
Cell Count (X)	
Cell Count (Y)	
Cell Height	Zellenhöhe
Cell Size	Zellen Größe
Cell Size Specification	Zellgröße Beschreibung
Cell Sizes	Zellengröße
CellSize to S-N Extent	Zellgröße in S-N Ausdehnung
CellSize to W-E Extent	Zellgröße in W-E Ausdehnung
Cells	
Cellsize	Zellgröße
Cellular Automata	
Center Versus Neighbours	Mitte versus Nachbarn
Center of Triangles	Mitte des Dreiecks
Centered	
Central Meridian	
Central Parallel	
Central Projection	Zentralprojektion
Centre	
Centroid X	
Centroid Y	
Centroids	Schwerpunkt
Centroids for each part	Schwerpunkt für jeden Teil
Change Cell Values	Ändere Zellwerte
Change Grid Values	Ändere Rasterwerte
Change Grid Values - Flood Fill	Ändere Rasterwerte - Flächenfüllung
Change Vector Analysis	Veränderungsvektor Analyse
Changed Grid	Geändertes Raster
Channel Definition Threshold (ha)	
Channel Direction	
Channel Network	
Channel Network Base Level	
Channel Network: Pass 1	
Channel Network: Pass 2	
Channel Network: Pass 3	
Channel Network: Pass 4	
Channel Network: Pass 5	
Channel Network: Pass 6	
Channel Skeleton	Kanalgerüst
Channel definition threshold	
Channel side slope(m/m)	
Channels	
Channels (Raster)	
Channels (Vector)	
Charcoal to Environment	
Chart (bars):	Diagramm (Balken)
Chart (sectors):	Diagramm (Sektoren)
Chart Type	Diagrammtyp
Check Point Validity	
Chessboard	
Choose Attribute	Wähle Attribut
Choose Cut from ...	Wähle Zuschnitt von..
Choose Documentation Folder	Wähle Dokumentenordner
Choose Grid	Wähle Raster
Choose Grid Project	Wähle Rasterprojekt
Choose Grid System	
Choose ODBC Connection	Wähle ODBC Verbindung
Choose Shapes	
Choose Time Range	
Choose a flow routing algorithm that shall be used for the overland flow distance calculation:\n- D8\n- MFD	
Choose a method	
Choose case: Rook's case contiguity compares only cell wich share an edge. Queen's case contiguity compares also cells which share just corners.	
Choose if you want to segmentate either on minima or on maxima.	Wähle bei einer Aufteilung entweder minima oder maxima.
Choose method how to adjust input values.	Wähle Methode wie die Eingabewerte anzupassen sind
Choose the Point Data Record Format you like to use	
Choose the attributes to use for clustering:	
Choose whether the input file's NoData value or a user specified NoData value is written	
Choose whether to reclassify a Point Cloud or to extract a subset from a Point Cloud.	Wähle ob Punktwolken reklassifiziert oder eine Teilmenge einer Punktwolke ausgewählt werden soll
Choose which quantiles you would like to calculate	Wähle das zu berechnende Quantil
Circle	Kreis
Circle Point Distance [Degree]	Entfernung der Kreislinienpunkte [in Grad]
Circles	
Circular	rund
Class	Klasse
Class 1	Klasse 1
Class 2	Klasse 2
Class Identifier	Klassenidentifizierer
Class Information	Klassen Information
Class Selection	Klassenauswahl
Classes	Klassen
Classification	Einteilung
Classification Constant	
Classification Quality	Aufteilungsqualität
Classification and segmentation tools for metric gridded data.	Einteilungs- und Aufteilungswerkzeuge für metrische gerasterte Daten
Classify	
Clay	Kleie
Clay-Loam	Kleie-Lehm
Clear	Löschen
Clear Fast Representativeness	
Clear Generalisation	
Clear RGA	
Climate Data	
Climate Data (P, EP)	
Clip Grid with Polygon	Schneide Rasterdaten mit Polygon zu
Clip Points with Polygons	Schneide Punkte mit Polygon aus
Clipped Points	Ausgeschnittene Punkte
Clipping Options	Ausschneide Optionen
Close	Schließen
Close Gaps	Schließe Lücken
Close Gaps with Spline	Schließe Lücken mit Spline
Close One Cell Gaps	Schließe Einzellenlücken
Closed Gaps Grid	Raster mit geschlossenen Lücken
Closest Point	nächstgelegener Punkt (Pf.)
Closing Gaps...	
Closing Pt. X	
Closing Pt. Y	
Cluster	Gruppe
Cluster Analysis	Gruppenanalyse
Cluster Analysis PC	
Cluster Analysis for Grids	Gruppenanalyse für Raster
Cluster Analysis for Point Clouds	
ClusterID	GruppenID
Clusters	Gruppen
Coefficient of Determination	
Collect values	Sammele Werte
Color	Farbe
Color Attribute	Farbattribute
Color Blending	Farbe Mischung
Color Palette	
Color Palette Rotation	Farbe Palettenwechsel
Color Stretch	
Color Triangle Composite	Farbe Dreiecksgemisch
Colors	Farben
Colors Value Range	Farbwertebereich
Colors file could not be exported.	Farbdatei konnte nicht erstellt werden.
Colors file could not be imported.	Farbdatei konnte nicht geladen werden.
Cols	Spalten
Columns	Spalten
Combination A	
Combination B	
Combine Grids	Verbinde Raster
Combined Minimum Distance / Hillclimbing	kombinierte Minimalentfernung / Bergsteigeralgorithmus
Combined Shading	
Command Line Arguments	
Comment	
Commit	
Compare with...	Vergleiche mit..
Complete Intersection	Komplette Schnittmenge
CompleteLinkage	
Completed Grid	Vervollständigtes Raster
Completely contain	vollkommen umschlossen
Composite	Gemisch
Compound Probability	
CompuServe Graphics Interchange	
CompuServe Graphics Interchange (*.gif)	
Computed flow directions, 0=N, 1=NE, 2=E, ... 7=NW	
Concentration time (h)	
Condition	Bedingung
Cone (Down)	Kegel (abwärts)
Cone (Up)	Kegel (aufwärts)
Cone (down)	Kegel (abwärts)
Cone (up)	Kegel (aufwärts)
Confirm file caching	Dateipufferaktivierung jedesmal bestätigen
Connectivity Index (Pff).	Konnektivität Index
Connectivity Weighting	Konnektivität Gewichtung
Connectivity [Percent]	Konnektivität [Prozent]
Constant Variation Range [Degree]	
Constant variation range	
Constraints	Einschränkungen
Contain the center of	das Zentrum enthaltend
Contour Lines	Isolinien
Contour Lines from Grid	Isolinien von Rasterdaten
Contributions - A. Perego	
Contributions - T. Wutzler	
Contributions from Alessandro Perego.	
Contributions from Thomas Wutzler.	
Contributions|A. Perego	
Contributions|T. Wutzler	
Control Points	
Convergence	Annäherung
Convergence (FD8)	
Convergence Index	
Convergence Index (Search Radius)	
Convergence factor for Multiple Flow Direction Algorithm (Freeman 1991)	
Convergence factor for Multiple Flow Direction Algorithm (Freeman 1991).\nApplies also to the Multiple Triangular Flow Directon Algorithm.	
Convergence factor for Multiple Flow Direction algorithm	
Convergence factor for the \'Multiple Flow Direction\' algorithm (after Freeman 1991)	
Convergence_Radius Index	
Convert Data Storage Type	Wandle Datenspeichertyp um
Convert Lines to Polygons	Linien zu Polygonen umwandeln
Convert Points to Line	Punkte zu Linie umwandeln
Convert Polygon/Line Vertices to Points	Polygone/ Linienpunkte zu Punkten umwandeln
Convert Polygons to Lines	Polygone zu Linien umwandeln
Convert a Table to Points	Wandel eine Tabelle in Punkte um
Convert a shapes layer to a TIN\n\n	Wandelt eine Vektorebene in ein TIN um\n\n
Convert routes	
Convert track points	
Convert way points	
Converted Grid	Umgewandeltes Raster
Converts a TIN data set to shapes layers.\n\n	Wandelt einen TIN-Datensatz in eine Vektorebene um.\n\n
Conway's Life	
Coordenada X	
Coordenada X del punto de ignición (sólo si no se usa grid de puntos de ignición)	
Coordenada Y	
Coordenada Y del punto de ignición (sólo si no se usa grid de puntos de ignición)	
Coordinate Transformation (Grid List)	
Coordinate Transformation (Grid)	
Coordinate Transformation (Shapes List)	
Coordinate Transformation (Shapes)	
Coordinate Transformations based on the GeoTRANS-Engine of the National Imagery and Mapping Agency (NIMA).	
Coordinates	
Copy	Kopieren
Copy Rule	Kopierregel
Copy Settings from...	Kopiere Einstellungen von..
Copying original data...	Kopiere Originaldaten…
Copyright (c) 2007 by Thomas Schorr	
Copyrights (c) 2003 by Andre Ringeler	
Copyrights (c) 2003 by Olaf Conrad	
Copyrights (c) 2003 by Volker Wichmann	
Copyrights (c) 2004 by Thomas Wutzler	
Copyrights (c) 2004 by Victor Olaya	Copyrights (c) 2004 by Victor Olaya
Copyrights (c) 2005 by Victor Olaya	
Copyrights (c) 2005 by Volker Wichmann	
Copyrights (c) 2006 by Victor Olaya	
Copyrights (c) 2006 by Volker Wichmann	
Copyrights (c) 2007 by Gianluca Massei	
Copyrights (c) 2007 by Volker Wichmann	
Copyrights (c) 2008 by Olaf Conrad	
Copyrights (c) 2009 Johan Van de Wauw	
Core	Kern
Corrected Image	
Corrected Transformed Vegetation Index	korrigierter umgewandelter Vegetationsindex
Correlation	
Correlation Matrix of the Fit Parameters:\n	Korrelationsmatrix der geeigneten Parameter:\n
Cosine Correction (Civco 1989)	
Cosine Correction (Teillet et al. 1982)	
Cost Grid	Kostengitter
Could not create data source.	
Could not create dataset.	
Count	Zählen
Count Only Above Base Level	Zähle nur über Ausgangsniveau
Count Only Below Base Level	Zähle nur unter Ausgangsniveau
Count Points in Polygons	Zähle Punkte in Polygonen
Covariance	
Covariance Surface	
Covered Distance	zurückgelegte Entfernung
Create 3D Image	Erzeuge 3D Bild
Create Chart Layer (bars/sectors)	Erzeuge Diagrammebene (Balken/Sektoren)
Create Constant Grid	Erzeuge konstantes Raster
Create Empty Table	Erzeuge leere Tabelle
Create Grid System	Erzeuge Rastersystem
Create HTML Documentation	Erzeuge HTML Dokumentation
Create KML File	
Create Lookup Table	Nachschlagetabelle erstellen
Create New Shapes Layer	Erzeuge neue Vektorebene
Create Output of Quarter Cell Grids	
Create PDF Docs	Erzeuge PDF Dokumente
Create PDF Documents	
Create Point Grid	Erzeuge Punktraster
Create Quality Grid	
Create Reference Points	
Create Variance Grid	
Create Web Content	Erzeuge Web-Inhalt
Create X/Y Grids	
Create a grid with pseudo-random numbers as grid cell values. 	Erzeuge ein Raster mit Pseudo-Zufallszahlen als Rasterwerten
Create graticule	Erzeuge Gitternetz
Create index	Index erstellen
Creates a color animation based on the values of selected grids.\n	Erzeuge eine Farbanimation auf der Basis der Werte des ausgewählten Rasters.\n
Creating module documentation files	Dateien zur Moduldokumentation erstellen
Croke et al. (2005)	
Croke et al. (2005) !!! not yet implemented !!!	
Crop Coefficients	
Crop to Data	Auf Daten zuschneiden
Cross Profiles	
Cross Sections	
Cross hatch	Kreuzschraffur
Cross-Classification Grid	Kreuzeinteilung Raster
Cross-Classification and Tabulation	Kreuzeinteilung und Auflistung
Cross-Tabulation	Kreuzauflistung
Cross-Tabulation Table	Kreuzauflistungstabelle
Cross-diagonal hatch	diagonale Kreuzschraffur
Cubic Spline Approximation	kubische Spline-Angleichung
Cubic: a + b * x + c * x^2 + d * x^3	Kubisch: a + b * x + c * x^2 + d * x^3
Cum.Covar.	
Cum.Var.	
Cumulative Variance	
Currently no help files exist for SAGA.\nIt depends on your support, if you will find any help at this place in future!\nThanks a lot...	Zur Zeit existiert keine Programmhilfe für SAGA\nEs hängt auch von Deiner/Ihrer Unterstützung ab, ob hier in Zukunft eine Hilfe zur Verfügung stehen wird.\nVielen Dank im voraus...
Curvature	
Curvature Classification	
Curve Number	
Cut	Schnitt
Cut Shapes Layer	Schneide Vektorebene zu
Cuts	Schnitte
Cutting	Schneiden
Cycles	
Cylindrical Equal Area	
D	
D/A	
D/sqrt(A)	D/Quadratwurzel (A)
D8	
D8 Flow Analysis	
D8 Flow Network	
DBase	
DD_FAC(	
DECLINE	Abnahme
DEFAULT	
DEFAULT_BRIGHT	
DELAY(	
DEM	DGM
DEMON	
DEMON - Min. DQV	
DEMON - Minium Drainage Quota Volume (DQV) for traced flow tubes	
DESCRIPTION	BESCHREIBUNG
DIFF_MEAN	
DSN	
DTM Filter (slope-based)	DGM Filter (Neigungsbasiert)
DXF Files (*.dxf)|*.dxf|All Files|*.*	
Danger	
Data	Daten
Data Manager	
Data Offset (Bytes)	
Data Source Name	Name Datenquelle
Data Table	Datentabelle
Data Type	
Data completion...	Daten ausführen…
Data storage type	Datenspeichertyp
Database	
Database (ODBC)	
Database Connection Error	
Database access through the libmysql.lib interface.	
Database with Coordinate Reference System (CRS) definitions. You have to restart SAGA to make changes take affect!	
Date Column	
Datum Definition	
Datum Shift	
Datum Shift Grid	
Datum Shift Grid File	
Datums (3 Parameters)	
Datums (7 Parameters)	
Day of Month	
Day of Year	
Day of Year (End of Range)	
Day-Degree Factor	
Day-Degree Factor (lower bound)	
Day-Degree Factor (upper bound)	
Day-Degree Factor depends on catchment characteristics	
Dead Fuel Moisture 100H	
Dead Fuel Moisture 10H	
Dead Fuel Moisture 1H	
Dead after	
December	
Declination [Degree]	
Declination []	
Declination of the light source, measured in degree above the horizon.	
Deepen Drainage Routes	
Default	
Default Filter Matrix (3x3)	
Default Weight	
Define AOI by ...	Definiere AOI durch.. 
Degree	Grad
Delete Fields	Felder löschen
Delineated watershed basins	
Denormalisation	
Density Index (Pf).	Dichteindex (Pf.)
Density [Percent]	Dichte [Prozent]
Density from Neighbourhood	Dichte aus Nachbarschaft
Dependent Variable	
Dependent on chosen method, these are distances or probabilities.	Abhängig von der gewählten Methode sind dieses Entfernungen oder Wahrscheinlichkeiten.
Dependent on the chosen 'Initiation Grid' and 'Initiation Type' this value controls under which condition a channel is initiated.	
Depression-free digital elevation model	
Derivation of slope lengths from catchment areas. These are rough approximations! Applies not to Desmot & Govers' method.	
Description	Beschreibung
Descriptive name for the grid system	Anschaulicher Name für das Rastersystem
Desmot & Govers	
Desmot & Govers 1996	
Destination Points	Zielpunkte
Destriped Grid	
Destriping 1	
Destriping 2	
Details	
Detector type	
Deterministic 8	
Deterministic 8 (D8)	
Deterministic Infinity	
Deviation from Arithmetic Mean	
Deviation from Mean Value	
Dialog	
Dictionary Files (*.dic)	
Dictionary Files (*.lng)	
Dictionary for Proj.4/OGC WKT translations. You have to restart SAGA to make changes take affect!	
Dictionary for translations from built-in (English) to local language (editable text table)	
Difference	Differenz
Difference (A - B)	Differenz (A-B)
Difference (B - A)	Differenz (B-A)
Difference A - B	Differenz A - B
Difference from Arithmetic Mean	
Difference from Mean Value	
Difference from all neighbour's mean	
Difference to left neighbour	
Difference to left neighbour (using a while loop)	
Difference to local gradient.	
Diffuse Insolation	
Digital Elevation Model that has to be processed	
Digital Terrain Model	
Digital elevation model	
Dilation	
Dim01	
Dim02	
Dirección del viento	
Dirección del viento (grados desde el norte en sentido antihorario)	
Dirección del viento (grados desde el norte)	
Direct Insolation	
Direct to Diffuse Ratio	
Direction	Richtung
Direction [Degree]	
Direction of Minimum Standard Deviation	Richtung der minimalen Standardabweichung
Direction of Plane [Degree]	Richtung der Fläche [Grad]
Direction of max cost	Richtung der maximalen Kosten
Direction of max cost for each cell. In degrees	Richtung der maximalen Kosten für jede Zelle. In Grad
Direction of the light source, measured in degree clockwise from the north direction.	
Directional Average 1	
Directional Statistics	
Directional Statistics for Points	
Directional Statistics for Single Grid	
Directory, where temporary cache files shall be saved.	Verzeichnis, in dem temporäre Dateipuffer gespeichert werden sollen.
Display Range	Anzeigebereich
Dist.	
Distance	Entfernung
Distance (Grid Units).	Entfernung (Rastereinheiten).
Distance Grid	Distanzraster
Distance Matrix	Entfernungsmatrix
Distance Matrix Table	Distanzmatrixtabelle
Distance Overland	
Distance Threshold	Entfernungsschwellenwert
Distance Weighted (Inverse)	
Distance Weighted (Linear)	
Distance Weighted (inverse distance)	
Distance Weighting	Entfernungs Gewichtung
Distance X	Distanz X
Distance Y	Distanz Y
Distance between points (grid units).	Entfernung zwischen Punkten (in Rastereinheiten)
Distinct	
Diurnal Anisotropic Heating	
Divergence	Abweichung
Diversity	Diversität
Division	Division
Division by zero is not allowed !!!	
Dominance	Dominanz
Dot and dash style	Punkt-Strich-Stil
Dotted style	Gepunktet
Down	Ab
Down sort	Sortiere abwärts
Down-Scaling	herunterskalieren
Downslope Area	
Downslope Distance Gradient	
Downslope basins	
Drainage Network	
Draw a section each n points	
Driver	
Driver does not support file creation.	
Drop Point Cloud Attribute	Punktwolkenattribute fallenlassen
Dummy Grid	Attrappenraster
Duplicates	
Duration of Insolation	
Dust [ppm]	
Dust factor: 100 ppm (standard)	
ENUM_ID	
EPSG	
EPSG Code	
ERDAS files other than version 7.4 are not supported.	
ESRI Arc/Info ASCII Grids (*.asc)	
ESRI Arc/Info Binary Grids (*.flt)	
ESRI Arc/Info Grids	
ESRI E00 Files|*.e00;*.e0*|All Files|*.*	
ESRI Shape Files	ESRI Vektordateien [.shp]
ESRI Shapefiles	
ESRI WKT Files (*.prj)	
Each Line as new Profile	
East []	
Eccentricity (e)	
Eckert IV/VI	
Edge	Rahmen
Edge Contamination	
Edge threshold for nonlinear smoothing	
Edges	Kanten
Efective friction = stated friction ^f , where f = cos(DifAngle)^k.	effektive Reibung = vorgegebene Reibung ^f , wobei f = cos(DifWinkel)^k. 
Effective Air Flow Heights	
Element Shape	
Elements	Elemente
Elevation	Erhöhung
Elevation Grid	
Elevation [m]	
Elevation at Reference Station [m]	
Elevation grid	
Ellipsoid Definition	
Ellipsoid Height [m]	
Ellipsoids	
Enforce True Color	
Enumerate a Table Attribute	Zähle Tabellenattribute durch
Enumerate attribute of a table, i.e. assign to identical values of choosen attribute field unique identifiers.\n	Zähle ein Tabellenattribut durch, z.B. um gleichen Werten eines gewählten Attributfeldes einen spezifischen Identifizierer zuzuweisen.\n
Epsilon	
Equals	
Equation	
Equidistance	Äquidistanz
Equidistant Cylindrical	
Equivalent Moisture	
Equivalente Rectangle (Side 1)(m)	
Equivalente Rectangle (Side 2)(m)	
Erdas LAN/GIS files (*.lan, *.gis)|*.lan;*.gis|All Files|*.*	
Erosion	
Error	Fehler
Error : Wrong table. Check table dimensions	Fehler : Falsche Tabelle. Prüfe Tabellenabmessungen
Error : Wrong weights table. Check table dimensions	Fehler : Falsche Wichtungstabelle. Prüfe Tabellenabmessunge
Error at character #%d of the function: \n%s\n	Fehler bei Buchstabe #% der Funktion: \n%s\n
Error at character #%d of the function: \n%s\n%s\n	Fehler bei Zeichen #% der Funktion: \n%s\n%s\n
Error in Formula	Fehler in Formel
Error in Trend Calculation	Fehler in Trendberechnung
Error in formula	Fehler in Formel
Error parsing attribute fields: can't convert to number	
Error parsing attribute fields: field index out of range	
Error: invalid source and target references.	
Error: not enough reference points. The transformation requires at least 3 reference points.	
Error: source and target references differ in number of points.	
Estimated Noise (absolute)	abgeschätztes Rauschen (absolut) 
Estimated Noise (relative)	abgeschätztes Rauschen (relativ) 
Estimated noise in units of input data	abgeschätztes Rauschen in Einheiten der Eingabedaten
Estimated noise relative to mean standard deviation	abgeschätztes Rauschen relativ zur mittleren Standardabweichung
Euclidean	
Exaggeration	Überhöhung
Exclude NoData Cells	Zellen ohne Wert ausschließen
Exit SAGA	SAGA beenden
Exponent	
Exponential Model	
Exponential Regression	
Exponential and Gaussian Weighting Bandwidth	Bandweite Exponentielle und Gaussche Gewichtung
Export Atlas Boundary File	
Export ESRI Arc/Info Grid	
Export GPX	
Export GStat Shapes	
Export Grid to XYZ	
Export Image (bmp, jpg, png)	
Export LAS Files	
Export Scalable Vector Graphics (SVG) File	
Export Shapes to Generate	
Export Shapes to XYZ	
Export Surfer Blanking File	
Export Surfer Grid	
Export TIN to Stereo Lithography File (STL)	
Export Text Table	
Export True Color Bitmap	
Export WASP terrain map file	
Export descriptions	
Export names	
Export z values	
Expression	Ausdruck
Extended Neighourhood	erweiterte Nachbarschaft
Extent	Umfang
Extent [Cut]	Umfang [Zuschneiden]
Extent to CellSize	Abhängig von Zellgröße
Extents	Umfange
Extraction of...	
Eye Distance	Augendistanz
FLOW	VERLAUF
Factor	
Fade Color Count	
Failed to initialise search engine.	Suchmaschine konnte nicht gestartet werden.
False Easting	
False Easting [m]	
False Northing	
False Northing [m]	
Fast Region Growing Algorithm	
Fast Representativeness	
Feature Aggregation	
Feature Space Options	
Features	Merkmale
Features Grid	Merkmalsraster
Features are all pixels different not representing no-data.	
February	
Feigenbaum's Bifurcation	
Ferhat Bingöl (c) 2009	
Field	Feld
Field (ID)	Feld (ID)
Field (Name)	Feld (Name)
Field Capacity [mm]	
Field Definition	
Field Description	
Field Name	Feldname
Field Properties	Feldeigenschaften
Field Separator	
Field Type	Datentyp
Field for File Naming	Feld für Dateibenennung
Field for Summary	Feld für Zusammenfassung
Fields	Felder
Fields for diagram	Feld für Diagramm
Figure	Bild
File	
File Name	
File Naming	Dateibenennung
File contains headline	
File does not exist:	
File error	
Files	Dateien
File|ESRI E00	
File|GDAL/OGR	
File|GPS Import	
File|Grid	
File|Reports	
File|Shapes	
File|Table	
File|Tables	
Fill Color	Füllfarbe
Fill NoData	Füllen der NoData-Zellen
Fill Sinks	
Fill Sinks (Planchon/Darboux, 2001)	
Fill Sinks (Wang & Liu)	
Fill Sinks XXL (Wang & Liu)	
Fill Value	Füllwert
Filled DEM	
Filter	
Filter Clumps	Filter Klumpen
Filter Matrix	
Filtered DTM	Gefiltertes DGM
Filtered Grid	Gefiltertes Raster
Final Parameters	
Final processing...	
Finalize	
Find Outlets	
Find Pits	
Fire Length	
Fire Length (min)	
Fire Risk Analysis	
First Class	Erste Klasse
First Day	
First input grid	
Fit	Passend
Fit 2.Degree Polynom (Bauer, Rohdenburg, Bork 1985)	
Fit 2.Degree Polynom (Heerdegen & Beran 1982)	
Fit 2.Degree Polynom (Zevenbergen & Thorne 1987)	
Fit 3.Degree Polynom (Haralick 1983)	
Fit Color Palette to Grid Values	Passe Farbpalette an Rasterwerte an
Fit Extent	
Fit N Points to shape	N Punkte an Vektor anpassen
Fitting range	
Fixed angle	
Fixed value to be replaced	Auszutauschender fester Wert
Fixed|Cell value|	Fest|Zellwert|
Flame Length	
Flame Length (m)	
Flat Area Values	
Flat Areas	
Flat Detection	
Flats	
Flattening	
Flattening (f)	
Flip	Kippen
Floating Point (4 byte)	Fließkommazahl (4 Byte)
Floating Point (8 byte)	Fließkommazahl (8 Byte)
Flooded digital elevation model	
Flow Accumulation	Verlauf Akkumulierung
Flow Accumulation (Parallel)	Verlauf Akkumulierung (Parallel)
Flow Accumulation (Trace)	Verlauf Akkumulierung (Spur)
Flow Accumulation, Mass-Flux Method	
Flow Algorithm	
Flow Connectivity	
Flow Correction	
Flow Depth	
Flow Depth Grid (m)	
Flow Direction	Verlauf Richtung
Flow Direction (up and down)	Verlauf Richtung (auf und ab)
Flow Directions	
Flow Lines	
Flow Network	
Flow Path Length	
Flow Path Profile	
Flow Routing Algorithm	
Flow Sinuosity	
Flow Split Method	
Flow Tracing	
Flow Width	
Flow at Gauges	
Folder	Ordner
Folder for PDF Files	
Format	
Formula	Formel
Formula String	
Forward diagonal hatch	Diagonalschraffur vorwärts
Fourier Transformation (Imaginary)	
Fourier Transformation (Real)	
Fractal Dimension	
Fractal Dimension of Grid Surface	
Fractal Type	
Fractals	
Fragmentation	Aufteilung
Fragmentation (Alternative)	Aufteilung (Alternative)
Fragmentation (Standard)	Aufteilung (Standard)
Fragmentation Classes from Density and Connectivity	Aufteilungsklassen aus Dichte und Konnektivität
Fragmentation Index	Aufteilungsindex
Frequency	Frequenz
Fuel Model	
Function	Funktion
Function Fit	Funktionsanpassung
Function Fitting Range	
Function Parameters	Funktionsparameter
Function failed because no attributes are available	Funktion schlug fehl, weil keine Attribute verfügbar sind.
Fuzzified	unscharf
Fuzzified Grid	
Fuzzify	Unschärfe
Fuzzy Intersection	
Fuzzy union grid	unscharfe vereinigte Raster
GDAL: Export Raster	
GDAL: Export Raster to GeoTIFF	
GDAL: Import Raster	
GPS Exchange Format (*.gpx)	
GPSBabel	
GPSBabel path	
GPX Import	
GPX file	
GPX files (*.gpx)|*.gpx|All Files|*.*	
GPX to shapefile	
GREEN_BLUE	
GREEN_GREY_BLUE	
GREEN_RED_BLUE	
GRID	
GStat Files (*.gstat)	
GStat shapes format export.	
GStat shapes format import.	
GWR Intercept	
GWR Quality	
GWR Regression	
GWR Slope	
Game Level	
Games	
Gauges	
Gaussian	Gaußsche
Gaussian Filter	Gaußfilter
Gaussian Landscape	
Gaussian Landscapes	
Gaussian Model	
Gaussian and Exponential Weighting Bandwidth	
General	Allgemein
General Settings	
Generalisation	
Geo-Reference	
GeoTRANS (Shapes)	
GeoTRANS engine initializing error!\n\nPlease check your data path settings!	
GeoTrans (Grid)	
Geocentric Coordinate System	
Geodetic	
Geographic Coordinate System	
Geographic Coordinate Systems	
Geographically Weighted Multiple Regression	
Geographically Weighted Multiple Regression (Points/Grids)	
Geographically Weighted Regression	
Geographically Weighted Regression (Points/Grid)	
Geoid	
Geometric Figures	Geometrische Figur
Geometrical Properties of Polygons	Geometrische Eigenschaften der Polygone
Georeferencing - Grids	
Georeferencing - Move Grid	
Georeferencing - Shapes	
Geostatistics - Grids	
Geostatistics - Kriging	
Geostatistics - Points	
Geostatistics - Regression	
Geostatistics|Grids	
Geostatistics|Kriging	
Geostatistics|Points	
Geostatistics|Regression	
Get CRS Definition from...	
Get Grid Data for Shapes	Erhalte Rasterdaten für Vektoren
Get Shapes Extents	Nimm Vektorumfang
Get table from MySQL server.\n	
Global Moran's I for Grids	
Gnomonic	
Gpx2shp path	
Gradient	
Gradient Difference	
Gradient Vectors	
Gradient Vectors from Grid(s)	
Gradient threshold	
Graticule	Gitternetz
Graticule type	Gitternetztyp
Greater than	Größer als
Green	Grün
Green-Ampt Infiltration	
Grid	Raster
Grid - Analysis	Raster - Auswertung
Grid - Calculus	Raster - Berechnung
Grid - Calculus BSL	Raster - Berechnung BSL
Grid - Filter	Raster - Filter
Grid - Gridding	Raster - Rastern
Grid - Spline Interpolation	Raster - Spline Interpolation
Grid - Tools	Raster - Werkzeuge
Grid - Visualisation	Raster - Visualisierung
Grid 1	Raster 1
Grid 2	Raster 2
Grid A	
Grid A. Final	Raster A. endgültig
Grid A. Init	Raster A. anfänglich
Grid B	
Grid B. Final	Raster B. endgültig
Grid B. Init	Raster B. anfänglich
Grid Buffer	Rasterpuffer
Grid Calculator	Raster Rechner
Grid Difference	Raster Differenz
Grid Display Defaults	Voreinstellungen Rasterdarstellung
Grid File Caching	Dateipufferung für Raster
Grid Interpolation	
Grid Manager	
Grid Masking	Raster Abdeckung
Grid Normalisation	Raster Normierung
Grid Orientation	Raster Ausrichtung
Grid Project	Raster Projekt
Grid Properties	Raster Eigenschaften
Grid Proximity Buffer	Raster Nachbarschaftspuffer
Grid Segmentation	Raster Aufteilung
Grid Segmentation (b)	Raster Aufteilung (b)
Grid Size	Raster Größe
Grid Skeletonization	Raster Gerüst
Grid Statistics for Polygons	Rasterstatistik für Polygone
Grid System	Rastersystem
Grid System Extent	Gridsystem Ausmaß
Grid Type	
Grid Value Request	Rasterwertabfrage
Grid Values	Rasterwerte
Grid Values [Cells]	
Grid Values [Nodes]	
Grid Values to Points (randomly)	Rasterwerte zu Punkten (zufällig)
Grid Values to Shapes	
Grid Volume	Raster Volumen
Grid based or related calculations.	Rasterbasiert oder ähnliche Berechnungen
Grid defining the zones to analyse. This grid also acts as a mask. Coding: no-data / categorial values.	
Grid range	Raster Bereich
Grid to TIN	Raster zu TIN
Grid to TIN (Surface Specific Points)	Raster zu TIN (Oberflächenspezifische Punkte)
Grid to filter	zu filterndes Raster
Grid to reclassify	neueinzuteilendes Raster
Grid value equals low value	Rasterwert ist gleich zu niedrigem Wert
Grid with category of nearest source cell [Category]	Raster mit Gruppen nächster Ausgangszellen [Gruppen]
Grid with euclidian distance to nearest source cell [grid units]	Raster mit euklidischer Entfernung zu nächsten Ausgangszellen [Rastereinheiten]
Grid with features to be buffered [Category/NoData]	Raster mit Merkmalen die zu puffern sind [Gruppen/NoData]
Grid(s)	Raster
Grid(s) to fit extent to	Raster, die Abmessung bestimmen
Grid_Normalised	Raster_normalisiert
Grids	Raster
Grids Product	
Grids Sum	
Grids from classified grid and table	Raster von geordnetem Raster und Tabelle
Grids to Merge	zu verschmelzende Raster
Grids to analyse	
Grids to request	abzufragende Raster
Grids used to delineate the UCUs. Coding: no-data / categorial values.	
Grids with continuous data, statistics are calculated for each grid. Coding: no-data / continuous values.	
Grid|Analysis	Raster|Auswertung
Grid|Calculus	Raster|Berechnung
Grid|Filter	Raster|Filter
Grid|Gridding	Raster|Rastern
Grid|Tools	Raster|Werkzeuge
Grid|Visualisation	Raster|Visualisierung
Group A	Gruppe A
Group B	Gruppe B
Group by	
Hafer	
Has Field Names	
Have their center in	Das Zentrum haben in…
Having	
Headers	
Height	Höhe
Height (Cells)	Höhe (Zellen)
Height Threshold	
Height of Atmosphere [m]	
Height of Atmosphere and Vapour Pressure	
Height of the light source above ground.	
Height of view point	
Height threshold for optimal profile calculation	
Hello by G. Massei	
Hemisphere	
Herbaceous Fuel Moisture	
High Value	Großer Wert
High variation for low sizes	
Hilditch's Algorithm	Hilditch´s Algorithmus
Hill-Climbing (Rubin 1967)	Bergsteigeralgorithmus (Rubin 1967)
Histogram	
Histogram Surface	
Homogenous	
Horizontal Overland Flow Distance	
Horizontal Range	Horizontaler Bereich
Horizontal hatch	horizontale Schraffur
Horizontally mirrored	horizontal gespiegelt
Humedad del combustible herbáceo vivo	
Humedad del combustible leñoso vivo	
Humedad del combustible muerto en 1-hora	
Humedad del combustible muerto en 10-horas	
Humedad del combustible muerto en 100-horas	
Humification Factor	
Humus to Charcoal	
Hypsometric Curve	
Hypsometry	
I am a module library template.	
I'm diggin'...	
I'm fillin'...	
I1: unrecognizable operator	I1: nicht erkannter Operator
I2: too many parameters	I2: zu viele Parameter
I3: corrupted buffer	I3: beschädigter Pufferspeicher
I4: size estimate too small	I4: Größe falsch eingeschätzt
ID	ID
IHACRES Basin	
IHACRES Basin (Dialog 2)	
IHACRES Calibration (2)	
IHACRES Distributed Input Dialog 2	
IHACRES Elevation Bands	
IHACRES Elevation Bands (Dialog 2)	
IHACRES Elevation Bands Calibration	
IHACRES Input Table	
IHACRES Model Parameters	
IHACRES Model Parameters (Calibration)	
IHACRES Version	
IHACRES Version 1.0	
IHACRES_Basin_output	
Identifier	Bezeichner
If checked the snow module is active	
If checked, it means there is no external inflow to the subbasin	
If checked, snow-melt module is used.	
If checked, then a second output table with all Time Series data is created.	
If checked, then temperature data are used.	
If grid is not set, a new one will be created using chosen width and height.	
If not set points will be removed from the orignal lines layer.	
If not set property attributes will be added to the orignal lines layer.	Falls nichts anderes ausgewählt wird werden die enthaltenen Attribute zur originalen Linienebene zugefügt
If table exists...	
Ignition Points	
Ignore Defaults	
Ignores specified attribute ('Save Attribute') and saves all attributes.	
Image	
Image (Blue Channel)	
Image (Green Channel)	
Image (Red Channel)	
Image File	
Image Files	Bilddateien
Image Grid	
Image Import/Export.	
Image Resolution	Bildauflösung
Image Rotation [Degree]	Bilddrehung [Grad]
Image segmentation algorithms.	
Imagery	Symbolik
Imagery - Classification	Symbolik - Einteilung
Imagery - OpenCV	
Imagery - Segmentation	
Imagery - ViGrA	
Imagery|OpenCV	
Imagery|Segmentation	
Imagery|ViGrA	
Images|*.bmp;*.jpg;*.png;*.tif|HTML Files|*.htm|All Files|*.*	Bilder|*.bmp;*.jpg;*.png;*.tif|HTML Dateien|*.htm|Alle Dateien|*.*
Imaginary	
Import	
Import Atlas Boundary File	
Import Binary Raw Data	
Import DB Table from MySQL	
Import DXF Files	
Import ESRI Arc/Info Grid	
Import ESRI E00 File	
Import Erdas LAN/GIS	
Import Filter	
Import GPS Data	
Import GPX	
Import GRIB2 record	
Import GStat Shapes	
Import Grid from Table	
Import Grid from XYZ	
Import Image (bmp, jpg, png, tif, gif, pnm, xpm)	
Import LAS Files	
Import MOLA Grid (MEGDR)	
Import Point Cloud from File	
Import Point Cloud from Text File	
Import SRTM30 DEM	
Import Scalable Vector Graphics (SVG) File	
Import Shapes from XYZ	
Import Stereo Lithography File (STL)	
Import Surfer Blanking Files	
Import Surfer Grid	
Import Text Table	
Import Text Table (Fixed Column Sizes)	
Import Text Table with Numbers only	
Import USGS SRTM Grid	
Import WASP terrain map file	
Import and export filter for ESRI's E00 file exchange format.	
Import/Export - DXF	
Import/Export - ESRI E00	
Import/Export - GDAL/OGR	
Import/Export - GRIB Files	
Import/Export - Grids	
Import/Export - Images	
Import/Export - LAS	
Import/Export - ODBC/OTL	
Import/Export - Shapes	
Import/Export - Tables	
Import/Export - Tables using MySQL native driver	
Importing	
Importing data ...	
In/Out	Eingabe/Ausgabe
Include Coordinates	
Include diagonal neighbour relations	Einschließlich diagonaler Nachbarbeziehungen
Infiltration excess runoff [m/dt]	
Infiltration rate [m/dt]	
Informe	
Init Fast Representativeness	
Init Generalisation	
Init RGA	
Initial Litter Storage [g/m\xc2\xb2]	
Initial Nitrogen Content [kg/ha]	
Initial Number of Distance Classes	
Initial Number of Fishes [%]	
Initial Number of Sharks [%]	
Initial Threshold for Slope	
Initial root zone storage deficit [m]	
Initial subsurface flow per unit area [m/h]	
Initialisation	Initialisierung
Initialization Value	Initialisierungswert
Initializing ...	
Initializing direction matrix...	
Initiation Grid	
Initiation Threshold	
Initiation Type	
Input	Eingabe
Input File	
Input File's NoData Value	
Input Grid	Eingaberaster
Input Grid 1	Eingaberaster 1
Input Grid 2	Eingaberaster 2
Input Grids	Eingaberaster
Input Specification	
Input file	
Input for module calculations.	
Input format	
Input grid	
Insert Additional Points	Zusätzliche Punkte einfügen
Insert Distance	Entfernung einfügen
Insert Method	Einfügemethode
Insert Position	Einfügeposition
Integer (1 byte)	Ganzzahl (1 Byte)
Integer (2 byte)	Ganzzahl (2 Byte)
Integer (4 byte)	Ganzzahl (4 Byte)
Intensidad	
Intensidad (Kcal/m)	
Intensity	
Intensity (Kcal/m)	
Interactive version (left mouse clicks will trigger the calculation for the selected cell).	
Intercept	
Intercept of the soil line	Achsenabschnit der Bodenlinie
Interior	Inneres
Internal subcatchment routing velocity [m/h]	
Interpolation	Interpolation
Interpolation Method	Interpolationsmethode
Interpolation Steps	Interpolationsschritte
Intersect	Schnittmenge
Intersection	Schnittfläche
Interval	
Interval between points (in grid units).	
Intervalo de tiempo entre capas (min)	
Invalid Buffer Distance	Unzulässige Pufferentfernung
Invalid File Format.	
Invalid Shapes	Unzulässige Vektordatei
Invalid X/Y fields.	
Invalid points layer.	Nicht zulässige Punktebene
Invalid polygon layer.	Nicht zulässige Polygonebene
Invalid shapes layer.	Nicht zulässige Vektorebene
Inverse	
Inverse Distance Interpolation	
Inverse Distance Offset	
Inverse Distance Power	
Inverse Distance Weighted	Inverse Distanzgewichtung
Inverse Distance Weighting Power	
Inverse transformation not available for selected projection type.	
Inversion	Umkehr
Invert	Umkehren
Invert Data/No-Data	Umkehr Daten/No-Data
Invert selection.	Auswahl umkehren.
Is the subbasin upstream (no external inflow)	
Isochrones Constant Speed	
Isochrones Variable Speed	
Iteration	
Iterationen	
Iterations	Iterationen
Iterative Minimum Distance (Forgy 1965)	Iterative Minimalentfernung (Forgy 1965)
JPEG - JFIF Compliant	
JPEG - JFIF Compliant (*.jpg, *.jif, *.jpeg)	
JPG Files	JPG Dateien
Jakeman & Hornberger (1993)	
January	
Johan Van de Wauw (c) 2009	
Join Table	Verbinde mit Tabelle
Join a Table	Verbinde mit Tabelle
Julia	
Julia - X	
Julia - Y	
Julia Set	
July	
June	
Kartoffeln	
Keep Base Level below Surface	
Keep the borders between segments as special values.	Behalte die Grenzen zwischen Segmenten als spezielle Werte.
Kernel	
Kernel Density	
Kernel Density Estimation	
Kind of initializing Precipitation Event	
Kinematic Routing Algorithm	
Kriging - geostatistical procedures for the gridding of irregular distributed point data.	
LAS Files (*.las)|*.las|All Files|*.*	
LENGTH	
LFAC(	
LNG_FILE_DIC	
LS-Factor	
Labels	
Lag Subbasin(	
Lag coefficient	
Lake	
Lake Flood	
Lambert Conformal Conic (1 parallel)	
Lambert Conformal Conic (2 parallel)	
Land Surface Temperature	
Land Surface Temperature [Deg.Celsius]	
Land Use	
Land Use ID	
Landsat	
Language Translations	
Laplace Filter	
Laplacian Filter	Laplace Filter
Last Day	
Lat. of True Scale	
Latitude	
Latitude (user defined reference)	
Latitude 1	
Latitude 2	
Latitude 3	
Latitude B	
Latitude Pole	
Latitude [degree]	
Latitude relates to grid's...	
Layer A	Ebene A
Layer B	Ebene B
Layer of extreme value	Ebene extremer Werte
Layers	Schichten
Layers to merge with main layer	Ebenen, die mit Hauptebene verbunden werden sollen
Layout	Layout
Leading zeros for data set numbering. Set to -1 for not using numbers at all.	
Leaf Area Index	
Leaf Size (for Speed Optimisation)	
Least Cost Path	Weg geringster Kosten
Least Cost Paths	
Least Squares Fitted Plane (Horn 1981, Costa-Cabral & Burgess 1996)	
Least cost path profile line	
Least cost path profile points	
Leaves	
Leaves to Litter	
Lectures - Introducing Module Programming	
Lectures|Introducing Module Programming	
Lee Factor	
Lee Filter	
Lee Filter - Direction	Lee Filter - Richtung
Lee Filter - Standard Deviation	Lee Filter - Standardabweichung
Left	Links
Left Border (X)	
Left Half	
Left/Right	Links/Rechts
Legend: Save	Legende: Speichern
Legend: Zoom	Legende: Vergrößerung
Length	Länge
Less than	Weniger als
Let pixel stay unclassified, if maximum likelihood probability is less than threshold.	Lasse Pixel unklassifiziert, wenn die maximale Wahrscheinlichkeit kleiner ist als der Schwellenwert.
Let pixel stay unclassified, if minimum or mahalanobis distance is greater than threshold.	Lasse Pixel unklassifiziert, wenn das Minimum oder die Mahalanobis-Distanz größer als der Schwellenwert ist.
Let pixel stay unclassified, if spectral angle distance is greater than threshold.	Lasse Pixell unklassifiziert, wenn die spektale Blickwinkelentfernung größer als der Schwellenwert ist.
Level	
Level Aggregation	flache Anhäufung
Level of Detail	Detaillierungsgrad
Level of Generalisation	
Library Overview	Bibliothek-Überblick
Life	
Life Cycle	
Life Cycles	
Lighting and visibility calculations for digital terrain models.	
Line Color	Linienfarbe
Line Endset (Bytes)	
Line Offset (Bytes)	
Line Order	
Line Properties	Linieneigenschaften
Line Simplification	
Line Transect(s)	
Line-Polygon Intersection	
Linear Flow	
Linear Flow Threshold	
Linear Flow Threshold Grid	
Linear Module	
Linear Regression	
Linear: a + b * x	
Lines	Linien
Lines and Points	Linien und Punkte
Lines with Property Attributes added	Linien mit erzeugten Eigenschaftenattributen
List of Grids	
List of Shapes Layers	
Litter to Humus	
Litterfall Rate [g/m\xc2\xb2/a]	
Little Endian (Intel)	
Ln(Area)	
Load Colors	Lade Farben
Load Parameters	Lade Parameter
Load shapefile	
Load shapefile after conversion	
Loading GSTAT-File	
Loam	Lehm
Loamy Sand	lehmiger Sand
Local Cartesian	
Local Maxima	Lokales Maximum
Local Minima	Lokales Minimum
Local Minima and Maxima	Lokale Minima und Maxima
Local Morphometry	
Local Rotation Base Level	Lokale Rotation der Grundlinie
Local Rotation [Degree]	Lokale Rotation [Grad]
Local Sky View Factor	
Local Time (user defined reference)	
Local time relates to grid's...	
Locate STRM30 Data File	
Locate...	
Location	
Location settings to be used, if no latitude/longitude grids are given.	
Logarithmic Transformation	
Logarithmic: a + b * ln(x)	Logarithmisch: a + b * ln(x)
Logo	
Lon. Down	
Long dashed style	lang gestrichelt
Longitude 1	
Longitude 2	
Longitude 3	
Longitude Pole	
Longitude [degree]	
Longitudinal Profile	
Look up table (Points)	
LookUp Table	Nachschlagetabelle
Lookup Table	Nachschlagetabelle
Lookup table used in method \"table\"	
Lookup table used in method \"user supplied table\"	
Lotsa	
Low Value	Unterer Wert
Low value < grid value < high value	Niedriger Wert < Rasterwert < hoher Wert
Low value <= grid value < high value	Niedriger Wert <= Rasterwert < hoher Wert
Low variation for low sizes	
Low-pass 1	
Low-pass 2	
Lower Border (Y)	
Lower Limit of real data	
Lower Tolerance	Untere Toleranz
LowerLimit	
Lumped Atmospheric Transmittance	
Lumped Atmospheric Transmittance [Percent]	
Luv Factor	
M	
MAX	
MAXIMUM	
MDE	
MEAN	MITTELWERT
MFD	
MIN	
MINIMUM	
MOLA Grids (*.img)|*.img|All Files|*.*	
MORAN_I	
MRRTF	
MRVBF	
MS Windows Bitmap (*.bmp)|*.bmp|All Files|*.*	
MSL Height [m]	
Maehweide	
Magnitude	Größenordnung
Mahalanobis Distance	Mahalanobisentfernung
Main Layer	Hauptebene
Main Layer. Output layer will have the same field in the attributes table as this layer	Hauptebene. Auszugebende Ebene hat die gleichen Felder der Attributtabelle wie diese Ebene
Main Radius	
Main channel routing velocity [m/h]	
Majority	
Majority Filter	
Make sure that the files\n	
Mandelbrot	
Mandelbrot Set	
Manhattan	
Manning's N	
Manning's Roughness	
Map	Karte
Map File	
Map Layer	
Map Manager	
Map Units	
Map/Table Size Ratio [%]	Karten/Tabellen Größenverhältnis [%]
Maps	Karten
March	
Mark Highest Neighbour	markiere obersten Nachbarn
Mask	Abdeckung
Mask Grid	
Mask Max	
Mask Min	
Mask value	
Masked Grid	Abgedecktes Raster
Mass Balance Index	
Massivity coef.	
Material	
Matrix signular\n	singulare Matrix\n
Max	
Max Iterations	
Max Lamda	
Max. Distance [km]	
Max. Iterations	
Max. Number of Classes	Max. Anzahl der Klassen
Max. Starvation Time for Sharks	
Max.Distance	Max. Distanz
Maxima	Maxima
Maximal Number of Points	Maximale Anzahl der Punkte
Maximum	
Maximum Cells (C Correction Analysis)	
Maximum Contour Value	Maximaler Isolinienwert
Maximum Deviation between estimated excess rainfall and observed streamflow volumes	
Maximum Deviation: ExcessRain-Streamflow [%]	
Maximum Distance	
Maximum Distance (km)	
Maximum Distance [Cells]	
Maximum Iterations	
Maximum Level	Maximalpegel
Maximum Likelihood	Maximale Wahrscheinlichkeit
Maximum Number of Observations	
Maximum Number of Points	Maximale Anzahl der Punkte
Maximum Overestimation of ExcessRain [%]	
Maximum Points	Maximale Punkte
Maximum Resolution (Percentage)	
Maximum Search Radius	
Maximum Search Radius (cells)	
Maximum Search Radius (map units)	
Maximum Size (Cells)	
Maximum Slope (Travis et al. 1975)	
Maximum Sum of overestimated ExcessRain to total ExcessRain in [%]	
Maximum Triangle Slope (Tarboton 1997)	
Maximum Value	Maximaler Wert
Maximum distance parameter is ignored if set to zero (default).	
Maximum flow distance(m)	
Maximum number of classes in entire grid.	maximale Anzahl der Klassen in vollständigem Raster
Maximum number of classes in the entire grid.	maximale Anzahl der Klassen in vollständigem Raster
Maximum number of grid cells used for trend analysis as required by C correction.	
Maximum resolution as percentage of the diameter of the DEM.	
Maximum root zone storage deficit [m]	
Maximum size	Maximalgröße
Maximum value of the range to be reclassified.	Maximaler Wert des neueinzuteilendes Bereiches
May	
Mean	
Mean Average	
Mean Centre	
Mean Elevation	Mittlere Erhöhung
Mean Elevation [m.a.s.l]	
Mean Value	Mittlerer Wert
Mean Value (cell area weighted)	Mittlerer Wert (Zellbereich gewichtet)
Mean less Standard Deviation	
Mean plus Standard Deviation	
Mean saturation deficit (in watershed) [m]	
Median	
Membership Function Type	
Memberships	Zugehörigkeit
Menu	Menü
Mercator	
Merge Shapes Layers	Verbinde Vektorebenen
Merged Grid	verschmolzenes Raster
Merged Layer	Verbundene Ebene
Merging	Verschmelzen
Method	Methode
Method (LS)	
Method (TWI)	
Method Angle	
Method for Lines	Methode für Linien
Method range	Methodenbereich
Method simple table	Methode einfache Tabelle
Method single	Methode einzeln
Method user supplied table	Methode durch Nutzer gelieferte Tabelle
Mid-Slope Positon	
Miller Cylindrical	
Min	
Min. Flow Speed (m/s)	
Min. Segment Length	
Min. Size	Minimale Größe
Min. Size (Cells)	Minimale Größe (Zellen)
Min./Max. Number of m_Points	
MinDist	
MinDist Region	
MinDistDir	
Mine Sweeper	
Minima	Minima
Minimal Number of Points	Minimale Anzahl der Punkte
Minimum	
Minimum Connectivity	
Minimum Contour Value	Minimaler Isolinienwert
Minimum Density [Percent]	Minimale Dichte [Prozent]
Minimum Density for Interior Forest [Percent]	Minimale Dichte für inneren Wald [Prozent]
Minimum Distance	Minimaldistanz
Minimum Distance Analysis	
Minimum Exaggeration [%]	Minimale Überhöhung [%]
Minimum Nash-Sutcliffe Efficiency	
Minimum Nash-Sutcliffe Efficiency required to print simulation to calibration table	
Minimum Number of Observations	
Minimum Segment Length (Cells)	
Minimum Size (Cells)	
Minimum Size [%]	
Minimum Slope [Degree]	
Minimum Standard Deviation	Minimum Standardabweichung
Minimum Value	minimaler Wert
Minimum size	Minimalgröße
Minimum size of basin (cells)	
Minimum slope gradient to preserve from cell to cell; with a value of zero sinks are filled up to the spill elevation (which results in flat areas). Unit [Degree]	
Minimum value of the range to be reclassified.	Minimaler Wert des neueinzuteilenden Bereichs
Minimum/Maximum	
Minnaert Correction	
Minnaert Correction with Slope (Law & Nichol 2004)	
Minnaert Correction with Slope (Riano et al. 2003)	
Mirror	Spiegeln
Mixed Flow Threshold (ha)	
Mode of operation	Operationsmodus
Model	
Model Parameters:	Modellparameter:
Model parameter [m]	
Modelling hydrological processes.	
Modelo de combustible	
Modifed Quadratic Shepard	Modifizierte quadratische Shepard-Methode
Modified catchment area	
Modify: post-processing...	
Modify: pre-processing...	
Module	Modul
Module Library	
Module Library Descriptions	Beschreibung Modulbibliothek
Module Library Template	
Module Manager	
Module Template	
Modules for GPS data handling.	
Mollweide	
Moment [h]	
Month	
Moore	
Moore et al. 1991	
Moran's I	
Morphometric Protection Index	
Move	Bewegung
Move Grid	
Moving window size = 1 + 2 * Neighborhood.	Bewegliche Fenstergröße = 1 + 2 * Umgebung
Multi Direction Lee Filter	Mehrrichtungs Lee Filter
Multi Scale Factor	
Multilevel B-Spline Interpolation	
Multilevel B-Spline Interpolation (from Grid)	Multilevel B-Spline Interpolation (von Rastern)
Multiple Flow Direction	mehrfache Verlaufsrichtungen
Multiple Flow Direction (FD8)	
Multiple Flow Direction (Quinn et al. 1991)	
Multiple Regression Analysis	
Multiple Regression Analysis (Points/Grids)	
Multiple Triangular Flow Directon	
Multiplication	Multiplikation
Multipoint	
Multiresolution Index of Valley Bottom Flatness (MRVBF)	
MySQL Data	
NAME	
NCELLS	
NEIGHBORS	
NEON	
NR	
NSE|NSE high flow|NSE low flow	
NTv2 Grid Shift Binary (*.gsb)	
NX	
NY	
N\xc3\xbamero of Monte-Carlo events	
Name	
Name Field	Namensfeld
Natural Neighbour	Natürliche Nachbarn-Methode
Navaladi, Schoeller, Conrad (c) 2009	
Near Infrared Band	Nahes Infrarotband
Nearest Neigbhor	
Nearest Neighbor	Nächster Nachbar
Nearest Neighbour	Nächste Nachbarn-Methode
Needs less memory, but is slow	
Needs more memory, but is quicker	
Neighborhood	Umgebung
Neighborhood Type	Umgebungstyp
Neighbourhood	Umgebung
Neon	
Net Primary Production [Gt Carbon / a]	
Network Density [%]	
Neumann	
New Grid Dimensions	
New Shapes Layer	Neue Vektorebene
New Value	Neuer Wert
New grid filtered with the A1WiTh module	
New grid filtered with the A2WiTh module	
New grid filtered with the A3WiTh module	
New grid filtered with the AvWiMa1 module	
New grid filtered with the AvWiMa2 module	
New grid filtered with the destriping1 module	
New grid filtered with the destriping2 module	
New grid filtered with the directional1 module	
New layer from selected shapes	Neue Ebene aus ausgewählten Vektoren
New selection	Neue Auswahl
New table	Neue Tabelle
New value.	Neuer Wert
Newton [A]	
Newton [B]	
Newton-Raphson	
Neys (Modified Lambert Conformal Conic)	
Nitrogen in Rainfall [kg/ha/a]	
No Cut	
No Data Value	
No Flats	
No Height	
No ODBC connection available!	Keine ODBC Verbindung möglich!
No duplicates found.	Keine Duplikate gefunden.
No grids selected	Keine Raster ausgewählt
No history available	Keine Verlaufsdarstellung möglich
No pen is used	Kein Stift im Gebrauch
No records selected.	Keine Datensätze ausgewählt.
No shapes in selection	Keine Vektoren ausgewählt
No sinks have been detected.	
No tables available in database!	
No translation set by user	
NoData Value	
NoData value(s) in statistic grid(s)!	
NoDataValue	
Node	
Non-Linear Module	
None	Nichts
Normalisation	
Normalise	Normalisieren
Normalised Grid	Normalisiertes Raster
Normalized	
Normalized Difference Vegetation Index	Normalisierte Differenz Vegetationsindex
Normalized Height	
Normalized Ratio Vegetation Index	Normalisiertes Verhältnis Vegetationsindex
North []	
North|South|	
Not Null	
Not a PostgreSQL database!	
Not a valid PostGIS database!	
Nothing to do: there is no intersection with additonal grid.	Nichts zu tun: es gibt keine Schnittmenge mit zusätzlichem raster
November	
No|Yes|	Nein|Ja|
Nugget	
Number of Attributes	Anzahl der Attribute
Number of Buffer Zones	Anzahl der Pufferzonen
Number of Classes	
Number of Clusters	
Number of Colors	Anzahl Farben
Number of Column Cells	
Number of Different Classes	Anzahl verschiedener Klassen
Number of Directions	Nummer der Richtungen
Number of Distance Classes	
Number of Elements	Anzahl der Elemente
Number of Events	
Number of Facettes	
Number of Fields	Anzahl der Felder
Number of Grid Cells	
Number of Pairs	
Number of Points	Anzahl der Punkte
Number of Points for Local Interpolation	Anzahl der Punkte für lokale Interpolation
Number of Points in Cell	Punktanzahl in Zelle
Number of Records	Anzahl der Datensätze
Number of Row Cells	
Number of Sectors	
Number of Simulations	
Number of Simulations for Calibration	
Number of Steps	
Number of Variables	
Number of additional attributes to import.	
Number of atttribute table columns.	Nummer der Attributtabellenspalte
Number of clusters	Anzahl der Gruppen
Number of decimals when writing floating point values in ASCII format.	
Number of horizontal tiles	Anzahl horizontaler Kacheln
Number of iterations, starts with search radius and increments with one cell by iteration.	Anzahl Iterationen, starten mit Suchradius und Zunahme mit einer Zelle je Iteration
Number of points	Punktanzahl
Number of points in the simplified line	Punktanzahl in vereinfachter Linie
Number of points on each side of the section	
Number of points per return:	
Number of sub-basins	
Number of the last x Iteration to be plotted.	
Number of vertical tiles	Anzahl vertikaler Kacheln
Numbering of Data Sets	
Numerical Values	numerische Werte
Numver of Fields	
O. Conrad (c) 2009	
O.Conrad (c) 2010	
ODBC Commit/Rollback Transaction	
ODBC Connect	
ODBC Database Connection Error	ODBC Datenbank Verbindungsfehler
ODBC Disconnect	
ODBC Execute SQL	
ODBC source connected	
OGR: Export Vector Data	
OGR: Import Vector Data	
Objective Function	
Objects removed from input grid	Objekte die aus dem Eingaberaster entfernt wurden
Oblique Mercator	
October	
Offset X	
Offset Y	
Offset Z	
Offset and Range (X)	
Offset and Range (Y)	
Ok	
Old Version	
One per x	Einer per x
Only Process Gaps with Less Cells	Nur Bearbeitung von Lücken mit wenigen Zellen
Only closing points on main stream	
OpenCV - Basic Morphological Operations	
OpenCV - Fourier Transformation	
OpenCV - Single Value Decomposition	
Operation	
Operator scale	
Opposite Neighbours	entgegengesetzte Nachbarn
Option	
Options	Optionen
Options for Data Thumbnails	Optionen für Daten-Vorschaubilder
Options for Map Thumbnails	Optionen für Karten-Vorschaubilder
Options:\n - Less than\n - Equals\n - Greater than\nControls under which condition a channel is initiated.	
Order by	
Order by...	Sortiert nach..
Ordered Weighted Averaging (OWA)	Sortierter gewichteter Durchschnitt (OWA)
Ordinary Kriging	
Ordinary Kriging (Global)	
Ordinary Kriging (VF)	
Ordinary Kriging (VF, Global)	
Orientation	
Origin Height	
Origin Latitude	
Original Image	
Orographic coef.	
Orthographic	
Ouput	Ausgabe
Outlet Hydrographs	
Output	Ausgabe
Output (imaginary)	
Output (real)	
Output Field Name	
Output File	
Output Grid	Ausgabe Raster
Output Lod	
Output Seeds	
Output Type	
Output Unit	Ausgabe Einheit
Output file	
Output format	
Output grid	
Output of Regression Parameters	
Output of module calculations.	
Overland Flow - Kinematic Wave D8	
Overland Flow Distance	
Overland Flow Distance to Channel Network	
Overlapping Cells	Überlappende Zellen
Overlay Image	Overlaybild
Override	
Overview	Überblick
P/A	
P/sqrt(A)	P/Quadratwurzel(A)
PCP Column: Subbasin: 	
PDF Docs	PDF Dokumente
PDF Documents	
PDF File	PDF Dateien
PDF Files	PDF Dateien
PDF Files (*.pdf)|*.pdf|All Files|*.*	PDF Dateien (*.pdf)|*.pdf|Alle Dateien|*.*
PERCENTILE	
PFAC(	
PNG Files	PNG Dateien
PVI (Perry & Lautenschlager)	
PVI (Qi, et al) 	
PVI (Richardson and Wiegand)	
PVI (Walther & Shabaani)	
Pairwise Comparisons Table 	Paarweise Vergleichstabelle
Panorama	
Panorama Break [%]	Panoramaunterbrechung [%]
Paper Format	Papierformat
Parallel Processing	
Parallelepiped	
Parameter	
Parameter (a)	
Parameter (b)	
Parameter (c)	
Parameter (c) to fit streamflow volume	
Parameter (l)	
Parameter (l) [lower bound]	
Parameter (l) [upper bound]	
Parameter (p)	
Parameter (p) [lower bound]	
Parameter (p) [upper bound]	
Parameter A for Power Function Regression:\n   y = A * x ^ B	
Parameter B for Exponential Regression:\n   y = Nugget * e ^ (B * x)	
Parameter B for Linear Regression:\n   y = Nugget + B * x	
Parameter B for Power Function Regression:\n   y = A * x ^ B	
Parameter settings for No-Data and all other values.	Parametereinstellungen für No-Data und alle anderen Werte.
Parameter settings for method range.	Parametereinstellungen für Methode Bereich.
Parameter settings for method simple table.	Parametereinstellungen für Methode einfache Tabelle.
Parameter settings for method single.	Parametereinstellungen für Methode einzeln.
Parameter settings for method user supplied table.	Parametereinstellungen für Methode nutzerdefinierte Tabelle
Parameters	Parameterliste
Parameters file could not be exported.	Parameterdatei konnte nicht erstellt werden.
Parameters file could not be imported.	Parameterdatei konnte nicht geladen werden.
Partial D.	
Partition Coefficients	
Parts	Teile
Pass 1	
Pass 2	
Password	Passwort
Patch	Korrektur
Patch Grid	repariertes Raster
Patching	Reparieren
Path	
Path for HTML Files	Pfad für HTML-Dateien
Pattern Analysis	Musterauswertung
Peak Flow (m3/s)	
Peak Flow (m3/s) at selected outlet cell	
Percentage of points	Prozentanteil der Punkte
Percentage of points remaining in the simplified line	Prozentanteil der Punkte, die in der vereinfachten Linie verbleiben
Percentage of standard deviation	Anteil der Standardabweichung
Percentile	
Percentiles	Perzentil
Perforated	perforiert
Perimenter	Umfang
Perimeter	Umfang
Perimeter (m)	
Permanent Wilting Point [mm]	
Permeability	
Peucker & Douglas	
Pick CRS from loaded data set	
Plan Curvature	
Plane	Fläche
Plane (%.2fDegree)	Fläche (%.2fGrad)
Planetary Radius	
Planetery Bending	
Please choose a method of module operation.	Bitte wähle eine Methode der Moduloperation.
Please stop module execution before exiting SAGA.	Um SAGA zu beenden, muß erst das laufende Modul angehalten werden.
Plot Holes	
Point	Punkt
Point Cloud	Punktwolkenattribute fallenlassen
Point Cloud Attribute Calculator	
Point Cloud Cutter	Punktwolken Zuschneider
Point Cloud Manager	
Point Cloud Reclassifier / Subset Extractor	Punktwolken Reklassifizierer / Teilbereichextraktor 
Point Cloud Thinning (simple)	Punktwolken Verdünner (einfach)
Point Cloud Viewer	Punktwolkenbetrachter
Point Cloud Viewer Settings	Einstellungen des Punktwolkenbetrachters
Point Cloud from Grid Points	Punktwolken von Rasterpunkten
Point Cloud from Shapes	Punktwolken von Vektoren
Point Cloud to Grid	Punktwolken von Rastern
Point Cloud to Shapes	Punktwolken zu Vektoren
Point Cloud to drop attribute from.	Punktwolken als Ziel für Attribute von..
Point Cloud to reclassify/extract	Punktwolken zu reklassifizieren / Auszug
Point Clouds	Punktwolken
Point Data Record Format	
Point Grid	Punktraster
Point Position	
Point Size: Default	Punktgröße: Voreinstellung
Point Size: Scaling	Punktgröße: Maßstab
Point Statistics for Polygons	
Point clouds viewer.	Punktwolkenbetrachter.
Point shapefile with source point(s)	
Point shapes import from text formated XYZ-table.	
Points	Punkte
Points Export	
Points Import	
Points Selection	Punkte Auswahl
Points from Lines	Punkte der Linien
Points per Cell	Punkte je Zelle
Points per Square	Punkte pro Quadrat
Polar Stereographic	
Polar To Rect	polar zu rect
Polyconic	
Polygon	
Polygon Centroids	Polygon Schwerpunkt
Polygon Intersection	Polygon Schnittmenge
Polygon Layers	Polygon Ebene
Polygon Shape Indices	Polygon Vektor Indizes
Polygon Union	Polygon Vereinigung
Polygons	Polygone
Polylines	
Population	
Port	
Portable Network Graphics	
Portable Network Graphics (*.png)	
Position	
Positive values result in a shift in E direction.	Positive Werte resultieren in einem verschieben in Ost-Richtung
Positive values result in a shift in N direction.	Positive Werte resultieren in einem verschieben in Nord-Richtung
Possible error	möglicher Fehler
PostGIS Shapes Export	
PostGIS Shapes Import	
Potential Incoming Solar Radiation	
Power	
Power Function - A	
Power Function - B	
Power Function Regression	
Power on soil (p)	
Power on soil (p) [lower bound]	
Power on soil (p) [upper bound]	
Power on soil moisture	
Power on soil moisture (p), lower bound	
Power on soil moisture (p), upper bound	
Power: a + b * x^c	
Pre-Processing	
Pre-defined Formulas	Vordefinierte Formel
Precipitation	
Precipitation Column	
Precipitation [mm]	
Predefined Datum	
Predefined Ellipsoids	
Predefined Functions	
Predefined Standard Ellipsoids	
Predictor	
Predictors	
Preferred Target Grid Type	Bevorzugter Zielrastertyp
Preferred data storage type	Bevorzugter Datenspeichertyp
Preprocessed DEM	
Preprocessed DEM. If this is not set changes will be stored in the original DEM grid.	
Preserve Data Type	Erhalte Datentyp
Primary Name	
Primary key)	
Priority Index	
Probability Reference	Wahrscheinlichkeit Referenz
Probability Threshold (Percent)	Wahrscheinlichkeitsschwellenwert (Prozent)
Process Update Frequency [milliseconds]	Prozess Update Frequenz [Millisekunden]
Processing	
Product	
Profile	
Profile (lines)	Profile (Linien)
Profile (points)	Profile (Punkte)
Profile Curvature	
Profile Distance	
Profile Length	
Profile Line	
Profile Points	
Profile Samples	
Profile [%s]	Profile [%]
Profile from points	
Profile_Line_[%s]_%d	
Profile_Points_[%s]_%d	
Profiles	
Profiles from Lines	
Proj.4	
Proj4 Parameters	
Project \'%s\'	Projekt \'%s\'
Projected Coordinate System	Projektkoordinatensystem
Projected Coordinate Systems	
Projected Height	Projektierte Höhe
Projection	Projektion
Projection - GeoTRANS	
Projection - Georeferencing	
Projection - Proj.4	
Projection Parameters	
Projection Settings	
Projection Type	
Projection_GeoTRANS_Datum_3.dat,\n	
Projection_GeoTRANS_Datum_7.dat,\n\n	
Projection_GeoTRANS_Ellipsoid.dat,\n	
Projection_GeoTRANS_Geoid_EGM96.dat,\n	
Projection|Georeferencing	
Protection Index	
Proximity	Nähe
Proximity Grid	Nachbarschaftsraster
Pythagoras' Tree	
QuadTree - Lines	QuadTree - Linien
QuadTree - Squares	QuadTree - Quadrate
QuadTree Structure to Shapes	QuadTree-Struktur für Vektoren
Quadratic	
Quadratic Neighbors	Quadratische Nachbarn-Methode
Quadric: a + b * x + c * x^2	Quadratisch: a + b * x + c * x^2
Quality	Qualität
Quality Measure	
Quantile Step	Quantile Schrittweite
Quantiles	Quantile
Queen	
Queen's case	
Query builder for shapes	Suchabfrage für Vektordaten
R2	
R:Alternatives	
R:Buffers	R:Puffer
R:Catchment Area	
R:Classification	R:Einteilung
R:Conversion	R:Umwandlung
R:Cost Analysis	R:Kostenauswertung
R:Export	
R:Filter for Grids	
R:Fourier Analysis	
R:Fragmentation Analysis	R:Aufteilungsauswertung
R:Fuzzy Logic	R:unscharfe Logik
R:Grid Generation	R:Raster Erstellung
R:Image Analysis	R:Bildauswertung
R:Import	
R:Indices	
R:Interpolation from Points	R:Interpolation von Punkten
R:Lakes	
R:Segmentation	R:Aufteilung
R:Soil Analysis	R:Bodenauswertung
R:Spline Interpolation	
R:Terrain Analysis	R:Geländeauswertung
R:Tools	R:Werkzeuge
R:Values	R:Werte
R:Without Variogram Fit	
RAINBOW	
RANGE	
RED_BLUE	
RED_BLUE_GREEN	
RED_GREEN	
RED_GREEN_BLUE	
RED_GREY_BLUE	
RED_GREY_GREEN	
RGA	
RGB Composite	RGB Zusammensetzung
RGB coded data	
RGBOverlay	
ROI_N	
Radians	Radiant
Radius	
Radius (Cells)	Radius (Zellen)
Radius (cells)	Radius (Zellen)
Radius X	
Radius Y	
Radius is too small	Radius ist zu klein
Radius is too small for your Standard Deviation	Radius ist zu klein für deine Standardabweichung
Radius of Variance (Grid)	
Radius with Variance	
Rainbow	Regenbogen
Random Field	Zufallsfeld
Random Terrain Generation	zufällige Geländeerstellung
Range	Bereich
Raster Dimension	
Raster Resolution (Pixel Size)	
Raster Resolution (Pixels Size)	
Raster Resolution (Pixels X)	
Rate Constant for Litter Loss [1/a]	
Ratio Vegetation Index	Verhältnis Vegetationsindex
Raw Data File	
Ray Tracing	
Real	
Real Area Calculation	
Real Area Grid	
Recalculating all Regions Minimum Distances\n	
Reciprocal Flattening (rf)	
Reclassifed grid.	Neueingeteiltes Raster
Reclassifed or extracted Point Cloud.	Reklassifizierte oder wesentliche Punktwolken
Reclassification of distance grid to buffer zones with a width equal to the equidistance value.	Neueinteilung von Entfernungsraster zu Pufferzonen mit einer Breite entsprechend dem Äquidistanzwert.
Reclassified Grid	Neueingeteiltes Raster
Reclassify Grid Values	Teile Rasterwerte neu ein
Reclassify buffer distance to intervals of euqidistance ...	Wandle Pufferentfernungen in Intervalle von Äquidistanzen ein... 
Reclassify|Extract Subset|	Reklassifizieren|Extrakt Teilmenge|
Recreations - Fractals	
Recreations - Games	
Recreations|Fractals	
Recreations|Games	
Rect To Polar	Rect zu Polar
Recursive Upward Processing	
Red	Rot
Red Band	rotes Band
Reduction	
Reference Points (Origin)	
Reference Points (Projection)	
Refresh	aktualisieren
Regions Count of No-DataValue-Pixels	
Regions MinPixel	
Regression	
Regression Analysis (Points/Grid)	
Regression Function	
Regression Parameters	
Regularisation	Regelung
Relation B / A	Beziehung B / A
Relative Area	
Relative Height	
Relative Heights and Slope Positions	
Relative Richness	relativer Reichtum
Relative from cell value	Relativ vom Zellwert
Relative heights calculation...	
Relaxation	Entspannung
Remove Duplicate Points	Entferne doppelte Punkte
Remove every i-th point.	Entferne jeden i-ten Punkt
Removed Objects	entfernte Objekte
Rename Fields	Feld umbenennen
Replace Condition	Austauschbedingungen
Replace with	Ersetze durch
Reports - HTML	
Reports - PDF	
Representativeness	
Representativeness (Grid)	
Resampling	Neuberechnung
Rescale Range	Bereich Massstabsänderung
Rescale Values (0-255)	
Rescale to 0 - 1	Massstabsänderung von 0 - 1
Rescale to 0 - 1.0	Massstabsänderung von 0 - 1.0
Rescale to 0 - 255	Massstabsänderung von 0 - 255
Residual Analysis (Grid)	
Residuals	
Resolution	Auflösung
Result	Ergebnis
Result table	
Resulting Point Cloud.	Resultierende Punktwolke
Resulting Shapes	resultierende Vektoren
Resulting Value	sich ergebender Wert
Resulting shapes	resultierende Vektoren
Results	
Revert Palette	
Rho 8	
Right	Rechts
Rill/Interrill Erosivity	
River Headers	
Road Width	
Rook	
Rook's case	
Roots	
Roots to Humus	
Rotate	Drehen
Rotate Table	Drehe Tabelle
Rotate a table, i.e. swap rows and columns.\n	Drehe eine Tabelle, z. B. um Reihen und Spalten zu tauschen.\n
Rotation	
Rotation X	
Rotation Y	
Rotation Z	
Rotation angle [Degree]	
Roughness/Smoothness	
Routing	
Routing Error	
Rows	Reihen
Running Average	laufender Durchschnitt
Runoff	
SAGA Colors	SAGA Farben
SAGA Help	SAGA Hilfe
SAGA Module Libraries	SAGA Modulbibliothek
SAGA Parameter Files	SAGA Parameter-Datei
SAGA Point Clouds	SAGA Punktwolken
SAGA Project	SAGA Projekt
SAGA Projects	SAGA Projekte
SAGA RGB color	
SAGA User Group Associaton (c) 2002	
SAGA User Group Associaton (c) 2008	
SAGA Wetness Index	
SAGA interface to Frank Warmerdam's Geospatial Data Abstraction Library (GDAL).	
SAGA: Print Map	SAGA: Karte drucken
SECTIONS	
SPECIFIC	SPEZIFISCH
SQL Statement	
SQL Statment	
SRTM30 DEM Tiles (*.dem)|*.dem|All Files|*.*	
STDDEV	
STDDEV_HI	
STDDEV_LO	
STDDEV_MEAN	
STL Files	
SUM	
SVG - Scalable Vector Graphics Files (*.svg)	SVG - Scalable Vector Graphics Datei (*.svg)
SVG Interactive Map	
Sample Variogram	
Samples in range	
Sand	
Sandy Clay	sandiger Kleie
Sandy Clay-Loam	sandiger Kleielehm
Sandy Loam	sandiger Lehm
Saturation overland flow [m/dt]	
Save 3D Image Options	Speichern der Optionen der 3D-Darstellung
Save All Attributes	
Save Colors	Farben speichern
Save Georeference	Georeferenzierung speichern
Save Headline	
Save Parameters	Parameter speichern
Save Shapefile	Vektordatei sichern
Save Table Header	
Save all	Alles speichern
Save the results to the input shapefile.	Ergebnisse in Eingabevektordatei sichern 
Scalable Vector Graphics Files (*.svg)	
Scale	Massstab
Scale Factor	
Scale Factor X	Massstabsfaktor X
Scale Factor Y	Massstabsfaktor Y
Scale Point Size	Maßstab Punktgröße
Scale X	
Scale Y	
Scale Z	
Scale factors	
Scaling	
Scaling Factor for Attribute Value	Massstabsfaktor für Attributwert
Scatterplot	
Search Distance Increment	Suchdistanzerhöhung
Search Mode	Suche Betriebsart
Search Radius	Suche Radius
Search Range	Suchbereich
Search Text	
Search for...	
Search in attributes table	Suche in Attributtabelle
Search radius of kernel in cells.	Suchradius des Kernels in Zellen
Search text not found	
Second Class	Zweite Klasse
Second input grid	
Secondary Name	
Section	
Sections	
Seed Generation	
Seed Value	Keimwert
Seeds	Keime
Seeds Grid	
Seeds Only	
Segment ID	
Segmentation	
Segmente	
Segments	Segmente
Select * FROM test	
Select Grid	
Select Grid System	
Select Precipitation Column	
Select Temperature Column	
Select by theme	Auswahl nach Thema
Select features in Shapes 1 that fulfil this condition	Wähle Eigenschaft in Vektordatei 1 die diese Bedingungen erfüllt
Select file	
Select from Subdatasets...	
Select from current selection	Wähle aus aktueller Auswahl
Select operator: eg. min < value < max.	Wähle Operator: z.B. min < Wert < max.
Select the Column containing Discharge Values	
Select the Column containing Temperature Values	
Select the Column containing precipitation Values	
Select the column containing inflow data to the subbasin	
Select the column containing the Date	
Select the column containing the observed streamflow time series	
Select the desired method: 1. a single value or a range defined by a single value is reclassified, 2. a range of values is reclassified, 3. the lookup table is used to reclassify the grid.	Wähle die gewünschte Methode: 1. ein einzelner Wert oder ein durch einen einfachen Wert definierter Bereich wird neu eingeteilt, 2. ein Bereich von Werten wird neu eingeteilt, 3. die Nachschlagetabelle wird zur Neueinteilung des Rasters benutzt.
Select the desired operator (<;.;=; >;.); it is possible to define a range above or below the old value.	Wähle den gewünschten Operator (<;.;=; >;.); es ist auch möglich einen Bereich über oder unter dem alten Wert zu definieren.
Select the desired operator (min < value < max; min . value < max; min .value . max; min < value . max).	Wähle den gewünschten Operator (min < Wert <max; min .Wert < max; min .Wert . Max; min < Wert . Max).
Selection Color	Farbauswahl
Semi-Variances	
Semi-Variogram	
Semimajor Axis (a)	
Semimajor Axis and Eccentricity	
Semimajor Axis and Eccentricity Squared	
Semimajor Axis and Flattening	
Semimajor Axis and Reciprocal Flattening	
Semimajor Axis and Semiminor Axis	
Semimajor axis or equatorial radius.	
Semiminor Axis (b)	
Semiminor axis or polar radius.	
Semivariance	
Semivariogram	
Separate Line/Polygon Points	
Separate Shapes	Trenne Vektoren
Separate points by direction	Trenne Punkte durch Richtung
Separator	
Separator (other)	
September	
Server	
Set Coordinate Reference System	
Set \'false\' to execute the calculation for each point in grid. Set \'true\' tu calculate the flow of one single cell.	
Set extent by	Setze Ausdehnung durch
Set true if you want multipart polygons to become separate polygons.	Gebe true ein wenn mehrteilige Polygone zu seperaten Polygonen werden sollen
Shade	
Shading Method	
Shall I activate file caching for new grid.	Soll der Dateipuffer für die neuen Rasterdaten aktiviert werden?
Shape Index	Vektor Index
Shape Parameter for Elevation Percentile	
Shape Parameter for Slope	
Shape Type	Vektortyp
Shape Type Manager	
Shape(s)	Vektoren
Shape(s) to fit extent to	Vektoren die anzugleichen sind an
Shapes	Vektoren
Shapes (Grid Information)	Vektoren (Rasterinformationen)
Shapes - Grid	Vektoren - Raster
Shapes - Lines	Vektoren - Linien
Shapes - Lines (extended)	Vektoren - Linien (verlängert)
Shapes - Point Clouds	Vektoren - Punktwolken
Shapes - Point Clouds Viewer	Vektoren - Punktwolkenbetrachter
Shapes - Points	Vektoren - Punkte
Shapes - Polygons	Vektoren - Polygone
Shapes - Tools	Vektoren - Werkzeuge
Shapes - Transects	
Shapes 2	Vektoren 2
Shapes Buffer	Vektorenpuffer
Shapes Extent	Vektoren Auszug
Shapes Layers	
Shapes Manager	
Shapes Report	
Shapes Summary Report	
Shapes to Grid	Vektoren zu Raster umwandeln
Shapes to TIN	Vektoren zu TIN
Shapes to project	abzubildende Vektoren
Shapes_Merge	Verbundene Vektoren
Shapes|Grid	Vektoren|Raster
Shapes|Lines	Vektoren|Linien
Shapes|Lines|Transects	
Shapes|Point Clouds	Vektoren|Punktwolken
Shapes|Point Clouds|Visualisation	Vektoren|Punktwolken|Visualisierung
Shapes|Points	Vektoren|Punkte
Shapes|Polygons	Vektoren|Polygone
Shapes|Tools	Vektoren|Werkzeuge
Sharpen	Schärfen
Shear factors	
Shearing	
Shen-Castan	
Short Field Names	
Short Wave Radiation [kW/m2]	
Short dashed style	gestrichelt (kurz)
Show Categories	Zeige Kategorien
Show Logo at Start Up	Anzeige des Logos beim Startvorgang
Show Progress	Zeige Fortschritt
Show Result in Dialog	
Sibson	
Side Slope	
Sill	
Silt	Schluff
Silt-Loam	Schlufflehm
Silty Clay	schluffiger Kleie
Silty Clay-Loam	schluffiger Kleielehm
Similarity	Ähnlichkeiten
Simple	
Simple Filter	Einfache Filter
Simple Region Growing	einfache Anbaugebiete
Simple, flow path and swath profiles.	
Simplified Lines	vereinfachte Linien
Simplify Lines	Linien vereinfachen
Simulación (Viento variable)	
Simulando...	
Simulating...	
Simulation	
Simulation - Cellular Automata	
Simulation - Fire Spreading Analysis	
Simulation - Hydrology	
Simulation - Hydrology: IHACRES	
Simulation - Modelling the Human Impact on Nature	
Simulation Output	
Simulation Time	
Simulation Time Step [h]	
Simulation Time [h]	
Simulation|Cellular Automata	
Simulation|Ecology|Modelling the Human Impact on Nature	
Simulation|Fire Spreading	
Simulation|Hydrology	
Simulation|Hydrology|IHACRES	
Single Cell	
Single Flow Direction	Einzelne Verlaufsrichtung
Single Storage	
Single value	Einzelner Wert
Sink Drainage Route Detection	
Sink Removal	
Sink Route	
Sink Routes	
Sinuosity	
Sinusoidal	
Sites	
Size	
Size field	Feldgrösse
Size of Analysis Window	Größe des Auswertungsfensters
Size of smoothing filter	
Skeleton	Gerüst
Skip Number	
Skip cells (step value).	
Skip first line	
Skip first line as it contains column names.	
Sky View Factor	
Sky View Factor (Simplified)	
Slope	
Slope Height	
Slope Length	
Slope gradient to left neighbour [%%]	
Slope gradient to left neighbour [Degree]	
Slope of the soil line	Neigung der Bodenlinie
Smooth	Glätten
Smooth Rep	
Snow Module Parameters	
Snow Module on/off	
Soil Losses	
Soil Moisture	
Soil Moisture Content	
Soil Moisture Deficit	
Soil Moisture Power Eq.	
Soil Nitrogen	
Soil Texture	Bodentextur
Soil Texture Classification	Bodentextureinteilung
Soil losses (t/ha\xc2\xb7year)	
Soil moisture index (l)	
Soil moisture index (l) [lower bound]	
Soil moisture index (l) [upper bound]	
Soil moisture index threshold	
Soil moisture index threshold (l), lower bound	
Soil moisture index threshold (l), upper bound	
Soil texture	Bodentextur
Solar Constant [W / m\xb2]	
Solar Position	
Solid style	durchgezogen
Some Grid Analysis Tools.	Einige Rasterauswertungswerkzeuge
Sommergerste	
Sort	
Sort Grid	Sortiere Raster
Sort Table	Tabelle sortieren
Sort first by	Sortieren erst nach..
Sort second by	Sortieren nach zweitem..
Sort third by	Sortieren nach drittem..
Sorted Grid	Sortiertes Raster
Source	Quelle
Source Coordinate System Error	
Source Coordinate System Type Error	
Source Datum	
Source Datum Error	
Source Grid	Ausgangsraster
Source Parameter List Initialisation Error	
Source Parameters	
Source Point(s)	
Source Projection	
Source Projection Error	
Source Projection Parameters	
South	Süd
South []	
South-North	Süd-Nord
Spatial Point Pattern Analysis	
Spatial Reference	
Spatial Reference System Files (*.srs)	
Spatial and geostatistical analyses of point data.	
Special cases	Spezielle Fälle
Special visualisation functions for grids.	Besondere Visualisierungsfunktionen für Raster
Specific Catchment Area	
Specific Catchment Area (SCA)	
Specify a threshold value as minimum difference between neighboured segments.	Benenne einen Schwellenwert als Minimaldifferenz zwischen benachbarten Segmenten.
Spectral Angle Mapping	Spektralwinkel-Kartierung
Spectral Angle Threshold (Degree)	Spektralwinkel Schwellenwert (Grad)
Spectral Information Divergence	Spektralinformation Abweichung
Speed (m/s)	
Spherical Model	
Spline sensitivity, reduce to get smoother results, recommended: 80 < Tolerance < 200	Splinesensitivität, verkleinere für weichere Ergebnisse, empfohlen: 80 < Toleranz < 200
Split Channels	
Split Parts	Teile aufteilen
Split Shapes Layer	Vektorebene aufteilen
Split Shapes Layer Randomly	Vektorebene zufällig aufteilen
Split Table/Shapes by Attribute	Teile Tabelle/Vektoren durch Attribut
Square	Rechteck
Squared Eccentricity (es)	
Stability	
Standard	
Standard (max. 90Degree)	
Standard Deviation	Standardabweichung
Standard Deviation (Percent of Radius)	Standardabweichung (Prozent des Radius)
Standard Distance	
Standard Parallel	
Standard Terrain Analysis	
Standard deviation	
Standard kernel 3	
Standardized Height	
Start Project	Starte Projekt
Start Value	Startwert
Start Values	Startwerte
Starting flood fill...	Beginne Flutfüllung
Statistics	Statistik
Statistics for Grids	
Std.Dev.	
Steepest gradient (first version)	
Steepest gradient (second version)	
Stems	
Stems to Litter	
Step	
Step 1: low-pass of stripe	
Step 2: low-pass between stripe and its surruondings	
Stepwidth	Schrittweite
Stereo Eye Distance [Degree]	Stereo Augendistanz [Grad]
Stereographic	
Stop on Error	
Storage	
Storage Configuration	
Strahler Order	
Stream Power	
Stream Power Index	
Streamflow (obs.) Column	
Streamflow Column	
Strings in Quota	
Stripes distance	
Style	Stil
Subbasin 	
Subbasin Inflow	
Subbasins	
Subsurface flow [m/dt]	
Subtitle	Untertitel
Subtract Volumes Below Base Level	Ziehe Volumen unterhalb der Basislinie ab
Subtraction	
Sudoku	
Summary	Zusammenfassung
Summary Table	tabellarische Zusammenfassung
Summary table.	
Summary:\n	
Summary_	Zusammenfassung_
Sum|Min|Max|	
Sunrise	
Sunset	
Supervised Classification	beaufsichtigte Klassifizierung
Surface	
Surface Specific Points	
Surface hydraulic conductivity [m/h]	
Surfer Blanking Files (*.bln)|*.bln|All Files|*.*	
Surfer Grid (*.grd)|*.grd|All Files|*.*	
Surfer's No Data Value	
Swath Profile	
Swath Width	
Swath width measured in map units.	
Syntax error at position #%d: \n%s\n	Syntaxfehler an Position #%: \n%s\n
System	System
T Curvature	
T Slope	
T Vertical Distance to Channel Network	
TFAC(	
TIFF files (*.tif)	
TIN	TIN
TIN - Tools	TIN - Werkzeuge
TIN Centroids	
TIN Edges	
TIN Manager	
TIN Triangles	
TIN Voronoi	
TIN to Shapes	TIN zu Vektoren
TIN_Gradient	
TINs	
TMP Column: Subbasin: 	
TOPMODEL	
TOPMODEL - Simulation Output	
TOT_N	
TYPE	
T_MELT(	
T_RAIN(	
Table	Tabelle
Table (with Trend)	Tabelle (mit Trend)
Table - Calculus	Tabelle - Rechnung
Table - Tools	Tabelle - Werkzeuge
Table / Shapes	Tabelle / Vektoren
Table Deletion	
Table Export	
Table Field Description	
Table Import	
Table Manager	
Table Name	
Table calculator	Tabellenrechner
Table calculator for shapes	Tabellenrechner für Vektoren
Table could not be opened.	
Table does not contain any data.	
Table from Query	
Table from SQL Query	
Tables	Tabellen
Table|Calculus	Tabelle|Rechner
Table|Tools	Tabelle|Werkzeuge
Tagged Image File Format	Tagged Image Dateiformat
Tagged Image File Format (*.tif, *.tiff)	
Take Formula	
Target	
Target Area	
Target Areas	
Target Cellsize	
Target Coordinate System Error	
Target Coordinate System Type Error	
Target Datum	
Target Datum Error	
Target Dimensions	Zieldimension
Target Grid	Zielraster
Target Grid Type	
Target Grids	
Target Parameter List Initialisation Error	
Target Parameters	
Target Projection	
Target Projection Error	
Target Projection Parameters	
Temperature (2pm) [DegreeC]	
Temperature Column	
Temperature Gradient [Deg.Celsius/km]	
Temperature Modulation Factor (f)	
Temperature Modulation Factor f	
Temperature Threshold for Melting	
Temperature Threshold for Melting (lower bound)	
Temperature Threshold for Melting (upper bound)	
Temperature Threshold for Rainfall	
Temperature Threshold for Rainfall (lower bound)	
Temperature Threshold for Rainfall (upper bound)	
Temperature at Reference Station [Deg.Celsius]	
Template Menu|Template Sub Menu	
Template Module Sub Menu	
Temporary files	temporäre Dateien
Tension Threshold	Spannungsschwellenwert
Tension Threshold [m]	
Terrain Analysis	
Terrain Analysis - Channels	
Terrain Analysis - Compound Analyses	
Terrain Analysis - Hydrology	
Terrain Analysis - Lighting, Visibility	
Terrain Analysis - Morphometry	
Terrain Analysis - Preprocessing	
Terrain Analysis - Profiles	
Terrain Analysis: Compound Analyses.\nThis library depends on the following SAGA module libraries:\n- ta_channels\n- ta_flow\n- ta_indices\n- ta_lighting\n- ta_morphometry\n- ta_preproc\n	
Terrain Analysis|Channels	
Terrain Analysis|Hydrology	
Terrain Analysis|Lighting	
Terrain Analysis|Morphometry	
Terrain Analysis|Preprocessing	
Terrain Analysis|Profiles	
Terrain Path Cross Sections	
Terrain Ruggedness Index (TRI)	
Terrain View Factor	
Text	Text
Text File	
Text Files	Textdateien
Text Files (*.txt)	Textdateien (*.txt)
Text Table (*.txt)	
Text files (*.txt)	
The GeoTRANS engine could not be initialized !!\n\n	
The LAS output file.	
The Topographic Wetness Index: ln( Area / tan(Slope) )	
The angle between the surface and the incoming light beams, measured in radians.	
The column holding the X-coordinate.	
The column holding the Y-coordinate.	
The column holding the Z-coordinate.	
The delay after the start of rainfall, before the discharge starts to rise.	
The grid to filter.	zu filterndes Raster.
The grids geo-reference must be related either to the center or the corner of its lower left grid cell.	
The inverse selection is not implemented for input shapefiles with more than one polygon!	Die invertierte Auswahl ist nicht für die Eingabe von Vektordateien mit mehr als einem Polygon geeignet!
The method used to identify surface specific points.	Die Methode die zum Identifizieren spezifischer Oberflächenpunkte benutzt wird.
The numbers (starting from 1) of the fields to use for clustering, separated by semicolon, e.g. \"4;5;7\"	
The point cloud to export.	
The resulting grid gives the altitude above the channel network in the same units as the elevation data.	
The terrain exaggeration factor allows to increase the shading contrasts in flat areas.	
The transmittance of the atmosphere, usually between 60 and 80 percent.	
The unobstructed hemisphere given as percentage.	
The values in the specified radius is used in the average calculation only if its difference with the central value is lesser or equal to this threshold.	
The values of the resultant grid can be either the seed value (e.g. the local maximum) or the enumerated segment id.	Die Werte des resultierenden Rasters können entweder der Ausgangswert (z.B. lokales Maximum) oder die ausgezählte Segment ID sein.
Theme	
Theme Field	
There is no grid to request.	Es ist kein Raster zur Abfrage ausgewählt.
There is nothing to merge, because less than 2 grids have been selected.	Es gibt nicht zu verschmelzen, da weniger als 2 Raster ausgewählt wurden.
Thiam's Transformed Vegetation Index	Thiams umgewandelter Vegetationsindex
Thin Plate Spline (Global)	
Thin Plate Spline (Local)	Thin Plate Spline (Lokal)
Thin Plate Spline (TIN)	
Thin Plate Spline: solving matrix	Thin Plate Spline: Lösungsmatrix
This grid indicates the cells you want calculate the average.	
This grid is used to select cells.	
This is a Test!!!	Dieses ist ein Test!!
This is a floating point value parameter with double precision (8 bytes).	
This is the horizontal component of the overland flow	
This is the vertical component of the overland flow	
This must be your input data of type grid.	Dieses müssen die Eingabedaten des Typs Raster sein
This must be your input data of type shapes.	
This optional grid output contains the interpolated channel network base level elevations.	
This shapes layer will contain the resulting channel network in vector format (lines).	
This value is ignored if set to zero.	
This value is used as constant if no vapour pressure grid is given.	
This version uses all valid cells (not \'no data\' values) of given target grid to determine the contributing area.	
This will contain your output data of type grid.	
This will contain your output data of type shapes.	
Thomas Schorr (c) 2007	
Thomas Wutzler (c) 2004	
Threshold	Schwellenwert
Threshold (Grid Units)	Schwellenwert (Rastereinheiten)
Threshold (Init.)	Schwellenwert (Init.)
Threshold - Similarity	
Threshold Buffer	Schwellenwert Puffer
Threshold Elevation	
Threshold Error	Schwellenwertfehler
Threshold Grid	Schwellenwert Raster
Threshold Height	
Threshold Type	Schwellenwert Typ
Threshold [Percent]	Schwellenwert [Prozent]
Threshold for Elevation Percentile (Lowness)	
Threshold for Elevation Percentile (Upness)	
Threshold for Peucker & Douglas Algorithm	
Threshold for automatic mode [MB]	Schwellenwert für automatischen Betrieb [MB]
Threshold for different route	Schwellenwert für verschiedene Wege
Threshold for plane	
Thresholds	Schwellenwert
Thumbnail Size	Miniaturbildgröße
Thumbnails	Miniaturbilder
Tick Points	
Tiempo	
Tiempo de inicio (min)	
Tiempo de simulacion (min)	
Tile Size (X)	
Tile Size (Y)	
Tile Size Definition	
Tiles	Kacheln
Tiling	
Tilt	
Time	
Time Delay (Rain-Runoff)	
Time Delay after Start of Rainfall (INTEGER)	
Time Interval [a]	
Time Out (h)	
Time Out(h)	
Time Period	
Time Range	
Time Resolution [d]: Range of Days	
Time Resolution [h]: Day	
Time Span	
Time Span [a]	
Time Span [h]	
Time Stamp without date	
Time Step [h]	
Time [a]	
Time interval is to large for a stable solution.	
Time span used for the calculation of daily radiation sums.	
Time step size for a day's calculation given in hours.	
Time step size for a range of days calculation given in days.	
Tolerance	Toleranz
Tolerance (Degree)	Toleranz (Grad)
Tolerance [Degree]	
Tools for (geo)statistical analyses.	
Tools for (grid based) digital terrain analysis.	
Tools for Triangulated Irregular Network (TIN) processing.	Werkzeuge für die Berechnung dreieckiger irregulärer Netzwerke (TIN). 
Tools for digital terrain analysis.	
Tools for lines.	Werkzeuge für Linien
Tools for point clouds.	Werkzeuge für Punktwolken
Tools for polygons.	Werkzeuge für Polygone
Tools for the georeferencing of spatial data (grids/shapes).	
Tools for the gridding of points and other vector data.	Werkzeuge für das Rastern von Punkten und anderen Vektordaten
Tools for the import and export of ASPRS LAS files.	
Tools for the import and export of DXF files.	
Tools for the import and export of gridded data.	
Tools for the import and export of tables.	
Tools for the import and export of vector data.	
Tools for the manipulation of gridded data.	Werkzeuge für die Manipulation gerasterter Daten.
Tools for the manipulation of point vector data.	Werkzeuge für die Veränderung von Punktvektordaten
Tools for the manipulation of vector data.	Werkzeuge für die Veränderung von Vektordaten
Tools for the preprocessing of digital terrain models.	
Tools related to gridded and vector data (conversions, combinations, etc.).	Werkzeuge für gerasterte und Vektordaten (Kombinationen etc.)
Top	Oben
Top to Bottom	
Topgraphic Wetness Index	
Topographic Correction	
Topographic Indices	
Topographic Wetness Index	
Total	
Total Catchment Area (TCA)	
Total Catchment Area [km2]	
Total Insolation	
Total accumulated Material	
Total flow (in watershed) [m\xc2\xb3/dt]	
Total flow [m/dt]	
Total insolation, the sum of direct and diffuse incoming solar radiation.	
Total memory size	Gesamte Speichergröße
Tracing: Convergence	
Tracing: Max. Divergence	
Tracing: Stop after x cells with divergent flow	
Tracing: Weight	
Training Areas	Trainingsgebiete
Transactions	
Transect through polygon shapefile	
Transfer Coefficients	
Transform Point Cloud	Wandle Punktwolken um
Transform Shapes	Vektordaten umwandeln
Transformation	
Transformed	Umgewandelt
Transformed Vegetation Index	Umgewandelter Vegetationsindex
Transitional	vorübergehend
Translation	
Translation X	
Translation Y	
Translation Z	
Translation: X	
Translation: Y	
Transmissivity	
Transparency	Transparenz
Transversal radius	
Transverse Cylindrical Equal Area	
Transverse Mercator	
Tree	Baum
Trend	
Trend Surface	
Trend Surface Analysis	
Trend Surface Type	
Trend for Shapes Data	Trend für Vektordaten
Trend for Table Data	Trend für Tabellendaten
Triangles	Dreiecke
Triangulation	
True Scale Latitude	
TwFAC(	
Two Parallel Storages	
Two Storages in Series	
Two Storages in Series !!! not yet implemented !!!	
Type	Typ
Type in a value that shall be used for the chosen mathematical operation.	
Type of Output	
Type of Quality Measure	
Type of Surface	
Type of distance calculation	
Type of smoothing	
USGS SRTM Grids (*.hgt)|*.hgt|All Files|*.*	
Unable to open LAS file!	
Unable to open input file!	
Undefined Coordinate System	undefiniertes Koordinatensystem
Undetermined	unbestimmt
Uniform	einheitlich
Union	Verbindung
Union of	Vereinigung von
Unique	
Unit	
Unit Name	
Units	
Units for output radiation values.	
Universal Kriging	
Universal Kriging (Global)	
Universal Kriging (VF)	
Universal Kriging (VF, Global)	
Universal Transvers Mercator (UTM)	
Unknown	
Unsaturated zone time delay per unit storage deficit [h]	
Up-Scaling	Heraufskalieren
Up/Down	Auf/Ab
Update	
Update View	Aktualisiere Ansicht
Update Views	
Update cluster view while clustering.	Aktualisiere Gruppenansicht während der Gruppenbildung
Update view during simulation.	
Upper Tolerance	Obere Toleranz
Upslope Area	
Upslope Basins	
Use 5 percent confidence interval	Nutze 5 Prozent Vertrauensintervall
Use Confidence Interval	Nutze Vertrauensintervall
Use D8 if catchment area becomes higher than specified threshold (Cells).	
Use D8 if catchment area becomes higher than specified threshold.	
Use Offset	Nutze Versatz
Use Surfer's No-Data Value	
Use Target Area Polygon	
Use Z-Range	
Use field content	Nutze den Feldinhalt
Use only seed cells as starting points.	
Use sky view factor based on local slope (after Oke 1988), if no sky viev factor grid is given.	
Use the stipple bitmap	Benutze die verschattete Bitmap
Use the user dashes	Benutze den benutzerdefinierten Strich
Use this option to reclassify No-Data values independently of the method settings.	Nutze diese Option um No-Data-Werte unabhängig von der Methodenauswahl neu zu berechnen.
Use this option to reclassify all other values that are not specified in the options above.	Nutze diese Option um alle anderen Werte die nicht in den obengenannten Optionen ausgewählt wurden neu zu berechnen.
Use x -Values	Benutze x -Werte
User	Benutzer
User Defined	
User Defined Datum	
User Defined Extent	Benutzdefinierter Auszug
User Defined Filter	
User Defined Grid	Nutzerdefiniertes Raster
User Defined Grid System	
User Defined Kernel	
User Defined No Data Value	
User Defined NoData Value	
User Name	Benutzername
User defined	Benutzerdefiniert
User defined grid	Benutzerdefinertes Raster
User defined range	Benutzerdefinierter Bereich
User defined rank	
User defined rescale	Benutzerdefinierte Massstabsänderung
Username	
Using temperature data?	
Using the snow-melt module?	
VALUE	WERT
VARIANCE	VARIANZ
VARIATION	
Valley Depth	
Value	Wert
Value Count	
Value Grid	Wert Raster
Value Preparation	Wertaufbereitung
Value Range	Wertebereich
Value as RGB Code	Wert als RGB Code
Value for 'no data'	
Value in Grid 1	Wert in Raster 1
Value in Grid 2	Wert in Raster 2
Value of Target Function	
Value of right cells in the Mask Grid	
Value to be replaced	zu ersetzender Wert
Value to reclassify.	neu zu berechnender Wert
Value which is assigned to the dummy grid.	Wert der Attrappenraster zugeordnet ist
Values	Werte
Values between A and B increase from 0 to 1, values between B and C will be set to 1.	
Values between B and C will be set to 1, values between C and D decrease from 1 to 0.	
Values greater than D will be set to 0.	
Values lower than A will be set to 0.	
Van der Grinten	
Variance	Streuung
Variance (version 1)	
Variance (version 2)	
Variance Radius	
Variance in Feature Space	
Variance in Position Space	
Variogram	
Variogram (Dialog))	
Variogram Cloud	
Variogram Model	
Variogram Surface	
Various Authors	Verschiedene Autoren
Various authors.	verschiedene Autoren
Vector Ruggedness Measure (VRM)	
Vector Terrain Ruggedness (VRM)	
Vectorised class as...	Vektorisierte Klasse als..
Vectorising Grid Classes	Rasterklassen vektorisieren
Vectorizing headers...	
Vectorizing subbasins...	
Vegetation Index[distance based]	Vegetationsindex [entfernungsbasiert]
Vegetation Index[slope based]	Vegetationsindex [neigungsbasiert]
Velocidad del viento	
Velocidad del viento (km/h)	
Version	
Vertex Distance [Degree]	
Vertical (drainage) flux [m/dt]	
Vertical Distance	
Vertical Distance to Channel Network	
Vertical Overland Flow Distance	
Vertical Range	Vertikaler Bereich
Vertical hatch	vertikale Schraffur
Vertically mirrored	vertikal gespiegelt
ViGrA - Basic Morphological Operations	
ViGrA - Distance	
ViGrA - Edge Detection	
ViGrA - Fourier Filter	
ViGrA - Fourier Transform	
ViGrA - Fourier Transform (Real)	
ViGrA - Fourier Transform Inverse	
ViGrA - Smoothing	
ViGrA - Watershed Segmentation	
Victor Olaya (c) 2005	
Visibility	
Visibility (single point)	
Visible Sky	
Vol. +	
Vol. -	
Volker Wichmann (c) 2010, LASERDATA GmbH	
Volume: %f	Volumen: %f
Volumes	
W	
WARNING	
WARNING: %d invalid points skipped!	
WARNING: Skipping misformatted line (%.0f)!	
WARNING: selected attribute is not numeric; generating unique identifiers instead.	Warnung: das ausgewählte Attribut ist nicht numerisch; erzeuge stattdessen eindeutige Identifizierer.
WASP Map Files (*.map)	
WHITE_BLUE	
WHITE_GREEN	
WHITE_RED	
WKT Files (*.wkt)	
Wa-Tor	
Water	
Water Content [cm]	
Water Retention Capacity	
Water Vapour Pressure [mbar]	
Water content change across the wetting front	
Water content of a vertical slice of atmosphere in cm: 1.5 to 1.7, average=1.68	
Watershed Basins	
Watershed Basins (extended)	
Watershed Subbasins	
We must keep the coordinates, please choose another field than x,y,z!	Die Koordinaten werden benötigt, bitte wähle ein anderes Feld als x, y, z!
Weight	Gewichtung
Weight for Red Grid out of range (0..100) - Cannot execute module	
Weight for grid 	Gewichtung für Raster
Weighted	Gewichtet
Weighting	
Weighting Neighbors	Gewichtete Nachbarn
Weights	Massen
Well Known Text File	
West	
West []	
West-East	West/Ost
Wetness Index	
Wetness decline time constant (Tw)	
Wetness index	
Wetness index calculation...	
Wetting front suction [m]	
Where	
Width	Breite
Width (Cells)	Breite (Zellen)
Width of gradient filter	
Wind Direction	
Wind Direction (Degree)	
Wind Direction (degrees clockwise from north)	
Wind Effect	
Wind Effect (Windward/Leeward Index)	
Wind Speed	
Wind Speed (m/s)	
Wind direction (degrees clockwise from north)	
Wind speed (m/s)	
Windows or OS/2 Bitmap	Windows oder OS/2 Bitmap
Windows or OS/2 Bitmap (*.bmp)	
Wintergerste	
Winterraps	
Winterroggen	
Winterweizen	
Wood Fuel Moisture	
Write Field Names	
Write all calculated Time Series in a table?	
X	
X Axis	
X Column	
X Component	X Komponente
X Coordinates	
X Position	
X Values	X Werte
X is Column ...	
X offset	X Versatz
X-Coordinate	
X-Extent	X-Abmessung
X-Range	
X-Rotation	
X11 Pixel Map	X11 Pixelkarte
XYZ Files (*.xyz)	
XYZ export filter for shapes. 	
XYZ files (*.xyz)	
Y	
Y = a * X^b (power)	
Y = a + b * X (linear)	
Y = a + b * ln(X) (logarithmic)	
Y = a + b / X	
Y = a / (b - X)	
Y = a e^(b * X) (exponential)	
Y Axis	
Y Column	
Y Component	Y Komponente
Y Coordinates	
Y Position	
Y Values	Y Werte
Y is Column ...	
Y offset	Y Versatz
Y-Coordinate	
Y-Extent	Y-Abmessung
Y-Range	
Y-Rotation	
YELLOW_BLUE	
YELLOW_GREEN	
YELLOW_RED	
You have to choose a grid for comparison	Für den Vergleich sind Rasterdaten auszuwählen
You have to choose a shapes layer for comparison	Für den Vergleich ist eine Vektorebene auszuwählen
You must specify a reclass table with a minimium (field 1), a maximum (field 2) and a code value (field 3)!\n	Du musst eine Neueinteilungstabelle mit Minimum (Feld 1), Maximum (Feld 2) und Kodewert (Feld 3) auswählen!\n
You must specify a reclass table with a minimium of one record!\n	Du musst eine Neueinteilungstabelle mit mindestens einem Datensatz auswählen!\n
Z	
Z Attribute	
Z Axis	
Z Multiplier	
Z Value	Z Wert
Z Values	Z Werte
Z [max]	
Z [max_sd]	
Z [mean]	
Z [min]	
Z [min_sd]	
Z is Column ...	
Z-Range	
Z-Rotation	
ZONE	
Zero	Null
Zevenbergen & Thorne	
Zonal Statistics	
Zone	
Zone Grid	
Zoom View	Zoomblick
Zsoft Paintbrush	
Zsoft Paintbrush (*.pcx)	
Zuckerrueben	
[BTN] Add	Hinzufügen
[BTN] Add All	
[BTN] Apply	Anwenden
[BTN] Button	Knopf
[BTN] Cancel	Abbrechen
[BTN] Clear	Hau Wech!
[BTN] Count	Anzahl
[BTN] Delete	Löschen
[BTN] Down	Ab
[BTN] Execute	Mach Hinne
[BTN] Insert	Einfügen
[BTN] Invert	Invertieren
[BTN] Load	Laden
[BTN] Mirror	Spiegeln
[BTN] Okay	
[BTN] Presets	Voreinstellungen
[BTN] Random	Zufall
[BTN] Restore	Wiederherstellen
[BTN] Save	Speichern
[BTN] Up	Auf
[CAP] 3D-View	3D-Ansicht
[CAP] 3D-View: Player Sequence	3D-Ansicht: Abspielsequenz
[CAP] About SAGA	Über SAGA
[CAP] Anaglyph	
[CAP] Arithmetic Mean	Mittelwert
[CAP] Attribute	Attribut
[CAP] Attribute (Size)	Attribut (Größe)
[CAP] Attribute Values	
[CAP] Attributes	Attribute
[CAP] Author	Autor
[CAP] Background Color	Hintergrundfarbe
[CAP] Beep when finished	Ton wenn fertig
[CAP] Buffer Size MB	Pufferspeichergröße [MB]
[CAP] Cell Size	Zellgröße
[CAP] Chart	Diagramm
[CAP] Chart Properties	Diagrammkonfiguration
[CAP] Choose Directory	Wähle Verzeichnis
[CAP] Circles	Kreise
[CAP] Clipboard	Zwischenablage
[CAP] Close	Schließen
[CAP] Close and save modified data sets...	Schließen und veränderte Dateien speichern
[CAP] Color	Farbe
[CAP] Color by Attribute	Farbe durch Attribut gesteuert
[CAP] Coloring	Kolorieren
[CAP] Colors	Farben
[CAP] Create Script Command File	Kommando-Script erzeugen
[CAP] Data	Daten
[CAP] Data History	Datengeschichte
[CAP] Decimals	Dezimalzahlen
[CAP] Default Size	voreingestellte Größe
[CAP] Defaults	Voreinstellungen
[CAP] Delete	Löschen
[CAP] Description	Beschreibung
[CAP] Diagram	Diagramm
[CAP] Display	Darstellung
[CAP] Display Resolution	Auflösung
[CAP] Display Type	Darstellungsart
[CAP] Display: Cell Values	Darstellung: Zellwerte
[CAP] Display: Color Classification	Darstellung: Farbklassifikation
[CAP] Display: Label	Darstellung: Bezeichnung
[CAP] Display: Size	Darstellung: Größe
[CAP] Display: Visibility	Darstellung: Sichtbarkeit
[CAP] East	
[CAP] Edit	Editieren
[CAP] Edit Point Cloud	
[CAP] Edit Shapes	Vektordaten editieren
[CAP] Elevation	Höhe
[CAP] Errors	Fehler
[CAP] Exaggeration	Überhöhung
[CAP] Execution	Modulausführung
[CAP] Exit	Beenden
[CAP] Eye Distance [Degree]	Augenentfernung [Grad]
[CAP] Field	Feld
[CAP] Fields	Felder
[CAP] Figure	Figur
[CAP] File	Datei
[CAP] File Cache [MB]	
[CAP] Fill Color	Füllfarbe
[CAP] Fill Style	Füllstil
[CAP] Fit Map Scale	Maßstab anpassen
[CAP] Fit Size to Window	Größe an Fenster anpassen
[CAP] Fixed Maximum	Festes Maximum
[CAP] Fixed Minimum	Festes Minimum
[CAP] Font	Schriftart
[CAP] Frame	Rahmen
[CAP] Frame Width	Rahmenbreite
[CAP] General	Allgemein
[CAP] Graduated Color	Abgestufte Farben
[CAP] Grid	Raster
[CAP] Grid System	Raster System
[CAP] Grid Systems	Raster Systeme
[CAP] Grids	Raster
[CAP] Height	Höhe
[CAP] Histogram	Histogramm
[CAP] History	Verlauf
[CAP] Horizontal Align	horizontal ausgerichtet
[CAP] Html Extra Info	
[CAP] Index	
[CAP] Input	Eingabe
[CAP] Interpolated	Interpoliert
[CAP] Interpolation	
[CAP] Label	Bezeichnung
[CAP] Layers	Ebenen
[CAP] Legend	Legende
[CAP] Legend Border Colour	Farbe Legendengrenze
[CAP] Legend Frame Width	Rahmenbreite Legende
[CAP] Legend Scale	Massstab Legende
[CAP] Line Style	Linienstil
[CAP] Load	Laden
[CAP] Load Colors	Lade Farben
[CAP] Load Grid	Lade Raster
[CAP] Load Module Library	Lade Modulbibliothek
[CAP] Load Point Cloud	Lade Punktwolke
[CAP] Load Project	Lade Projekt
[CAP] Load Settings	Lade Einstellungen
[CAP] Load Shapes	Lade Vektordaten
[CAP] Load TIN	Lade TIN
[CAP] Load Table	Lade Tabelle
[CAP] Load Text	Lade Text
[CAP] Logarithmic Stretch Factor	Logarithmische Streckung
[CAP] Lookup Table	Nachschlagetabelle
[CAP] Map	Karte
[CAP] Map Extent	Kartenausdehnung
[CAP] Map Scale	Maßstab
[CAP] Map Selection	Kartenauswahl
[CAP] Map-Layout	Karten-Layout
[CAP] Maps	Karten
[CAP] Maximum	
[CAP] Maximum Value	Maximalwert
[CAP] Mean	Mittelwert
[CAP] Memory	Speicher
[CAP] Memory Compression	Speicherkommpression
[CAP] Memory Handling	Speicherverwaltung
[CAP] Memory Size [MB]	
[CAP] Messages	Nachrichten
[CAP] Minimum	Minimum
[CAP] Minimum Value	Minimalwert
[CAP] Mode	Modus
[CAP] Modified	Modifiziert
[CAP] Module Execution	Modulausführung
[CAP] Module Libraries	Modulbibliotheken
[CAP] Module Library	Modulbibliothek
[CAP] Modules	Module
[CAP] Name	
[CAP] No Data	Keine Daten
[CAP] No Data Cells	
[CAP] No Data Value	
[CAP] North	
[CAP] Number Of Cells	Anzahl der Zellen
[CAP] Number Of Grids	Anzahl der Rasterdatensätze
[CAP] Number Of Shapes	Anzahl der Vektordatensätze
[CAP] Number of Cells	
[CAP] Number of Columns	
[CAP] Number of Points	Anzahl der Zellen
[CAP] Number of Rows	
[CAP] Numerical Precision	
[CAP] Object Properties	Objektkonfiguration
[CAP] Open	Öffnen
[CAP] Options	Optionen
[CAP] Outline	Umrandung
[CAP] Outline Color	Umrandungsfarbe
[CAP] Outline Size	Umrandungsgröße
[CAP] Overlay 1	
[CAP] Overlay 2	
[CAP] Parameters	Parameter
[CAP] Perspectivic Distance	Perspektivischer Abstand
[CAP] Point Cloud	Punktwolken
[CAP] Point Clouds	Punktwolken
[CAP] Point Size	Punktgröße
[CAP] PointCloud	Punktwolken
[CAP] Points	Punkte
[CAP] Preset Selection	Vorgabe Auswahl
[CAP] Print Layout	Drucklayout
[CAP] Print Preview	Druckvorschau
[CAP] Project File	Projektdatei
[CAP] Projection	Projektion
[CAP] Properties	Eigenschaften
[CAP] RGB Overlay	
[CAP] Records	Datensätze
[CAP] Regression Details	Regressionsdetails
[CAP] Regression Formula	Regressionsformel
[CAP] Rotation	Drehung
[CAP] Rotation (Degree)	Drehung (Grad)
[CAP] Rotation by Attribute	Drehung durch Attribut
[CAP] Save	Speichern
[CAP] Save As Image	Als Bild speichern...
[CAP] Save Colors	Farben speichern
[CAP] Save Grid	Raster speichern
[CAP] Save Grid as Image...	Raster als Bild speichern..
[CAP] Save Map as Image...	Karte als Bild speichern
[CAP] Save Point Cloud	Punktwolke speichern
[CAP] Save Project	Projekt speichern
[CAP] Save Settings	Einstellungen speichern
[CAP] Save Shapes	Vektordaten speichern
[CAP] Save TIN	TIN speichern
[CAP] Save Table	Tabelle speichern
[CAP] Save Text	Text speichern
[CAP] Save to PDF	Als PDF speichern
[CAP] Scale Dependent	Massstabsabhängig
[CAP] Scatterplot	
[CAP] Select File	Datei wählen
[CAP] Selection	Auswahl
[CAP] Settings	Einstellungen
[CAP] Shade	Schatten
[CAP] Shapes	Vektordaten
[CAP] Shift	
[CAP] Show	Anzeigen
[CAP] Show Always	Immer zeigen
[CAP] Show Centroid	Zeige Schwerpunkt
[CAP] Show Edges	Kanten anzeigen
[CAP] Show Filled	Ausgefüllt zeigen
[CAP] Show Legend	Legende anzeigen
[CAP] Show Nodes	Zeige Knoten
[CAP] Show Regression Curve	Regressionskurve anzeigen
[CAP] Show Scale	Zeige Massstab
[CAP] Show Vertices	Zeige Knotenpunkte
[CAP] Size	Größe
[CAP] Size Range	Größenspanne
[CAP] Size by Attribute	Größe durch Attribut
[CAP] Size relates to...	Größe abhängig von
[CAP] Snap Distance	Einrastdistanz
[CAP] Snap to...	Einrasten zu..
[CAP] South	
[CAP] South-North	Süd-Nord
[CAP] Standard	Standard
[CAP] Standard Deviation	Standardabweichung
[CAP] Symbol Image	Symbol Bild
[CAP] Symbol Type	Symbol Typ
[CAP] TIN	
[CAP] Table	Tabelle
[CAP] Table Description	Tabellenbeschreibung
[CAP] Tables	Tabellen
[CAP] This Is Not A Caption!	Dieses ist keine Beschriftung!
[CAP] Transparency [%]	Transparenz [%]
[CAP] Type	Typ
[CAP] Unique Symbol	Einheitliches Symbol
[CAP] Unit	Einheit
[CAP] Value	Wert
[CAP] Value Aggregation	Wertezusammenfassung
[CAP] Value Maximum	
[CAP] Value Minimum	
[CAP] Value Range	Wertebereich
[CAP] Value Type	Wertetyp
[CAP] Values	Werte
[CAP] Version	
[CAP] Vertical Align	vertikale Ausrichtung
[CAP] Weight	Wichtung
[CAP] West	
[CAP] West-East	West-Ost
[CAP] Width	Weite
[CAP] Workspace	Arbeitsumgebung
[CAP] X Axis	X-Achse
[CAP] Y Axis	X-Bezeichnung
[CAP] Z-Factor	Z-Faktor
[CAP] Zoom to added layer	Zoome zur hinzugefügten Ebene
[CAP] [no items]	[keine Objekte]
[CAP] [none]	[nicht gesetzt]
[CMD] About SAGA	Über SAGA
[CMD] Action	Aktion
[CMD] Add Field	Feld hinzufügen
[CMD] Add Part	Segment hinzufügen
[CMD] Add Position [A]	Position hinzufügen [A]
[CMD] Add Project	Projekt hinzufügen
[CMD] Add Record	Datensatz hinzufügen
[CMD] Add Shape	Objekt hinzufügen
[CMD] Anaglyph [S]	
[CMD] Arrange Icons	Ikonen anordnen
[CMD] Backward	Zurück
[CMD] Cascade	Überlappend
[CMD] Central Projection	Zentralprojektion
[CMD] Clear	Löschen
[CMD] Close	Schließen
[CMD] Close All	Alle schliessen
[CMD] Convert To Table	In Tabelle umwandeln
[CMD] Copy	Kopieren
[CMD] Copy Settings from other Layer	Kopiere Einstellungen von anderer Ebene
[CMD] Create HTML Documentation	Erzeuge HTML Dokumentation
[CMD] Create Lookup Table	Nachschlagetabelle erstellen
[CMD] Create Normalised Classification	Normalisierte Klassifikation erstellen
[CMD] Create Script Command File	Erzeuge Skript Kommando-Datei
[CMD] Cumulative	Kumulativ
[CMD] Decrease Diagram Size	Diagrammgröße verringern
[CMD] Decrease Exaggeration [F1]	Überhöhung verringern [F1]
[CMD] Decrease Eye Distance	Verringere Augenentfernung
[CMD] Decrease Perspectivic Distance [F5]	Verringere perspektivische Distanz [F5]
[CMD] Delete All Positions	Alle Positionen löschen
[CMD] Delete All Records	Entferne alle Datensätze
[CMD] Delete Fields	Entferne Felder
[CMD] Delete Last Position [D]	Letzte Position löschen [D]
[CMD] Delete Selected Part	Entferne ausgewählten Teil
[CMD] Delete Selected Point	Ausgewählten Punkt löschen
[CMD] Delete Selected Record(s)	Ausgewählten Datensatz löschen
[CMD] Delete Selected Shape(s)	Entferne ausgewählte Vektoren
[CMD] Down	Ab
[CMD] Edit Positions	Positionen editieren
[CMD] Edit Selected Shape	Ausgewähltes Vektorobjekt editieren
[CMD] Execute	Ausführen
[CMD] Exit	Beenden
[CMD] Exit SAGA	SAGA beenden
[CMD] Fit Column Sizes	Spaltengröße anpassen
[CMD] Fit Diagram to Window	Diagramm an Fenster anpassen
[CMD] Fit Grid Colors To Map Extent	Rasterfarben an Ausschnitt anpassen
[CMD] Fit Row Sizes	Reihengröße anpassen
[CMD] Fit Scale...	Maßstab anpassen...
[CMD] Forward	Vorwärts
[CMD] Help	Hilfe
[CMD] Increase Diagram Size	Diagrammgröße vergrößern
[CMD] Increase Exaggeration [F2]	Überhöhung verstärken [F2]
[CMD] Increase Eye Distance	Augendistanz vergrößern
[CMD] Increase Perspectivic Distance [F6]	perspektivische Distanz vergrößern
[CMD] Insert Record	Datensatz einfügen
[CMD] Interpolated Colors	Interpolierte Farben
[CMD] Invert Selection	Auswahl invertieren
[CMD] Left	Links
[CMD] Left [F3]	Links [F3]
[CMD] Load	Laden
[CMD] Load Grid	Lade Raster
[CMD] Load Module Library	Lade Modulbibliothek
[CMD] Load Point Cloud	Lade Punktwolke
[CMD] Load Project	Lade Projekt
[CMD] Load Settings	Lade Einstellungen
[CMD] Load Shapes	Lade Vektordaten
[CMD] Load TIN	Lade TIN
[CMD] Load Table	Lade Tabelle
[CMD] Measure Distance	Messe Entfernung
[CMD] Move Down	Eine Ebene nach unten
[CMD] Move To Bottom	Ganz nach unten
[CMD] Move To Top	Ganz nach oben
[CMD] Move Up	Eine Ebene nach oben
[CMD] New Project	Neues Projekt
[CMD] Next	Nächstes
[CMD] Page Setup	Seite einrichten
[CMD] Pan	Verschieben
[CMD] Play And Save As Images...	Abspielen und als Bilder speichern
[CMD] Play Loop [L]	Wiederholt abspielen
[CMD] Play Once [P]	Apspielen
[CMD] Previous	Voriges
[CMD] Print	Drucken
[CMD] Print Preview	Druckvorschau
[CMD] Print Setup	Drucker einrichten
[CMD] Properties	Eigenschaften
[CMD] Rename Fields	Felder umbenennen
[CMD] Right	Rechts
[CMD] Right [F4]	Rechts [F4]
[CMD] Save As Image when changed	Speichere als Bild wenn geändert
[CMD] Save As Image...	Als Bild speichern...
[CMD] Save Grid	Raster speichern
[CMD] Save Grid As Image...	Raster als Bilddatei speichern...
[CMD] Save Grid As...	Raster speichern unter...
[CMD] Save Legend to Clipboard [Ctrl+L]	Legende in Zwischenablage speichern [Strg+L)
[CMD] Save Point Cloud	Punktwolke speichern
[CMD] Save Point Cloud As...	Punktwolke speichern als..
[CMD] Save Project	Projekt speichern
[CMD] Save Project As...	Projekt speichern unter
[CMD] Save Shapes	Vektordaten speichern
[CMD] Save Shapes As...	Vektordaten speichern unter...
[CMD] Save TIN	TIN speichern
[CMD] Save TIN As...	TIN speichern unter...
[CMD] Save Table	Tabelle speichern
[CMD] Save Table As...	Tabelle speichern unter...
[CMD] Save to Clipboard [Ctrl+C]	In Zwischenablage speichern [Strg+C]
[CMD] Search for...	
[CMD] Set Range to Minmum/Maximum	Minimum/Maximum als Bereich auswählen
[CMD] Set Range to Standard Deviation (1.5)	Standardabweichung (1,5) als Bereich auswählen
[CMD] Set Range to Standard Deviation (2.0)	Standardabweichung (2,0) als Bereich auswählen
[CMD] Show	Anzeigen
[CMD] Show 3D-View	3D-Ansicht anzeigen
[CMD] Show Diagram	Diagramm anzeigen
[CMD] Show Grid	Raster anzeigen
[CMD] Show Histogram	Histogramm anzeigen
[CMD] Show Horizontal Legend	Legende horizontal anzeigen
[CMD] Show Layer	Schicht anzeigen
[CMD] Show Map	Karte anzeigen
[CMD] Show Message Window	Nachrichten anzeigen
[CMD] Show Object Properties	Objekteigenschaften anzeigen
[CMD] Show Point Cloud	Punktwolke anzeigen
[CMD] Show Print Layout	Kartenlayout anzeigen
[CMD] Show Scatterplot	Scatterplot anzeigen
[CMD] Show Shapes	Vektordaten anzeigen
[CMD] Show TIN	TIN anzeigen
[CMD] Show Table	Tabelle anzeigen
[CMD] Show Toolbar	Werkzeugleiste anzeigen
[CMD] Show Vertical Legend	Legende vertikal anzeigen
[CMD] Show Workspace	Arbeitsumgebung anzeigen
[CMD] Sort Fields	Felder sortieren
[CMD] Sort Selection to Top	Sortierte Auswahl nach oben
[CMD] Synchronise Map Extents	Kartenausschnitte synchronisieren
[CMD] Tile Horizontally	Horizontal anordnen
[CMD] Tile Vertically	Vertikal anordnen
[CMD] Tip of the Day...	Tipp des Tages...
[CMD] UNRECOGNISED COMMAND ID	NICHT ERKANNTE KOMMANDO ID
[CMD] Up	Auf
[CMD] Update Data	Daten aktualisieren
[CMD] Zoom	Vergrößerung
[CMD] Zoom To Active Layer	Auf ausgewählte Schicht zoomen
[CMD] Zoom To Extent	Auf Erstreckung zoomen
[CMD] Zoom To Full Extent	Auf volle Erstreckung zoomen
[CMD] Zoom To Next Extent	Auf nächste Erstreckung zoomen
[CMD] Zoom To Previous Extent	Auf vorige Erstreckung zoomen
[CMD] Zoom To Selection	Auf ausgewählte Elemente zoomen
[DAT] Cell size	Zellgröße
[DAT] Grid	Raster
[DAT] Line	Linie
[DAT] Lower left corner	Linke untere Ecke
[DAT] Number of cells	Anzahl der Zellen
[DAT] Point	Punkt
[DAT] Point Cloud	Punktwolke
[DAT] Points	Punkte
[DAT] Polygon	
[DAT] Shapes	Vektordaten
[DAT] TIN	
[DAT] Table	Tabelle
[DAT] Undefined	Undefiniert
[DAT] [not set]	[nicht gesetzt]
[DAT] new	neu
[DLG] Add layer to selected map	Datensatz zu ausgewählter Karte hinzufügen
[DLG] Delete selected point(s).	
[DLG] Delete selected shape(s).	Ausgewählte Vektordatenelemente löschen
[DLG] Invalid parameters!	Ungültige Parameter
[DLG] Please enter a numeric value:	Bitte geben Sie einen Zahlenwert ein:
[DLG] Save changes?	Änderungen speichern?
[DLG] Scale 1 : 	Maßstab 1 : 
[DLG] Select a layer to copy settings from it.	Eine Ebene zum Kopieren der Einstellungen auswählen.
[DLG] Set selected values to no data.	Auswahl als \'Keine Daten\' markieren.
[ERR] Calculation Error	Kalkulationsfehler
[ERR] Can't execute a module while another runs	Modul kann nicht ausgeführt werden, während ein anderes läuft
[ERR] Could not save PDF file.	PDF-Datei konnte nicht gespeichert werden.
[ERR] DBase file could not be opened.	Dbase-Datei konnte nicht geöffnet werden.
[ERR] DBase file does not contain any records.	DBase-Datei enthält keine Datensätze.
[ERR] Error: Continue anyway ?	Fehler: Fortsetzung unbestimmt
[ERR] Grid file could not be opened.	Rasterdatei konnte nicht geöffnet werden
[ERR] Grid file could not be saved.	Raster konnte nicht gespeichert werden
[ERR] Internal system error	Interner Systemfehler
[ERR] Invalid data set!	Ungültiger Datensatz!
[ERR] Invalid data!	Ungültige Daten!
[ERR] Invalid display size!	Ungültiger Ausgabebereich!
[ERR] Invalid library	Ungültige Bibliothek
[ERR] Library could not be loaded	Bibliothek konnte nicht geöffnet werden
[ERR] Library does not contain any modules	Bibliothek enthält keine Module
[ERR] Library has already been loaded	Bibliothek wurde bereits geladen
[ERR] Module caused access violation!	Modul erzeugt Zugriffsverletzung!
[ERR] Shape file could not be opened.	Vektordatei konnte nicht geöffnet werden
[ERR] There was a problem printing.\nPerhaps your current printer is not set correctly?	Es gab ein Druckproblem.\nVielleicht ist Ihr Drucker nicht korrekt eingestellt?
[ERR] Unknown Error	Unbekannter Fehler
[ERR] You canceled printing	Sie haben den Druckvorgang abgebrochen
[ERR] corrupted file header	Beschädigter Dateikopf
[ERR] corrupted record header	Beschädigter Datensatzkopf
[ERR] corrupted shapefile.	Beschädigte Vektordatei
[ERR] dbase file could not be opened	DBase-Datei kann nicht geöffnet werden
[ERR] file could not be opened.	Datei konnte nicht geöffnet werden
[ERR] incompatible file.	inkompatible Datei
[ERR] index file could not be opened	Indexdatei kann nicht geöffnet werden
[ERR] invalid file code	unzulässiger Dateicode
[ERR] memory allocation error.	Speicherzuordnungsfehler
[ERR] no records in file.	keine Datensätze in der Datei
[ERR] shape file could not be opened.	Vektordatei konnte nicht geöffnet werden
[ERR] unable to create file.	Datei konnte nicht erzeugt werden
[ERR] unsupported file version	nicht unterstützte Dateiversion
[ERR] unsupported shape type.	nicht unterstützter Vektortyp
[FLD] Attribute	Attribute
[FLD] Central Projection	Zentralprojektion
[FLD] Exaggeration	Überhöhung
[FLD] Grid	Raster
[FLD] Icon	Piktogramm
[FLD] Index Layer	Index Schicht
[FLD] Name	
[FLD] PDF Document	PDF Dokument
[FLD] Paper Format	Papierformat
[FLD] Rotate X	Drehung X
[FLD] Rotate Y	Drehung Y
[FLD] Rotate Z	Drehung Z
[FLD] Round Scale	Gerundeter Massstab
[FLD] SVG File	SVG Datei
[FLD] Shapes	Vektordaten
[FLD] Shift X	Verschiebung X
[FLD] Shift Y	Verschiebung Y
[FLD] Shift Z	Verschiebung Z
[FLD] Steps to Next	Anzahl der Schritte
[FLD] Title	Titel
[FLD] Value	Wert
[HLP] Execute Module	Modul ausführen
[HST] Created from file	Von Datei geladen
[MNU] ?	
[MNU] Attributes	Attribute
[MNU] Classification	Klassifikation
[MNU] Classificaton	Klassifikation
[MNU] Edit	Editieren
[MNU] File	Datei
[MNU] Grid	Rasterdaten
[MNU] Modules	Module
[MNU] Point Cloud	Punktwolke
[MNU] Project	Projekt
[MNU] Rotation	Drehung
[MNU] Sequencer	Sequenzer
[MNU] Shapes	Vektordaten
[MNU] Shift	Verschiebung
[MNU] TIN	
[MNU] Table	Tabelle
[MNU] Window	Fenster
[MSG] Build Histogram...	Histogramm erstellen...
[MSG] Close	Schließe
[MSG] Close Library	Schließe Bibliothek
[MSG] Close table	Schließe Tabelle
[MSG] Could not load project.	Projekt konnte nicht geladen werden
[MSG] Could not save project.	Projekt konnte nicht gespeichert werden
[MSG] Create TIN from shapes	TIN aus Vektordatensatz erstellen
[MSG] Executing module	Modul ausführen
[MSG] Execution has been stopped by user!	Modulausführung von Benutzer abgebrochen!
[MSG] Interactive module execution failed	Ausführung des interaktiven Moduls schlug fehl
[MSG] Interactive module execution has been started	Ausführung des interaktiven Moduls wurde gestartet
[MSG] Interactive module execution has been stopped	Ausführung des interaktiven Moduls wurde beendet
[MSG] Load grid	Lade Rasterdaten
[MSG] Load library	Lade Bibliothek
[MSG] Load point cloud	Lade Punktwolke
[MSG] Load project	Lade Projekt
[MSG] Load shapes	Lade Vektordaten
[MSG] Load table	Lade Tabelle
[MSG] Module execution failed	Modulausführung schlug fehl
[MSG] Module execution succeeded	Modul wurde erfolgreich ausgeführt
[MSG] Project has been saved.	Projekt wurde gespeichert
[MSG] Project has been successfully loaded.	Projekt wurde erfolgreich geladen
[MSG] Save as Interactive SVG	Speichere als interaktive SVG
[MSG] Save grid	Rasterdaten speichern
[MSG] Save point cloud	Speichere Punktwolke
[MSG] Save shapes	Vektordaten speichern
[MSG] Save table	Tabelle speichern
[MSG] Save to PDF	Als PDF speichern
[MSG] Shall execution be stopped?	Soll die Ausführung abgebrochen werden?
[MSG] could not read project file.	Projektdatei konnte nicht gelesen werden.
[MSG] failed	fehlgeschlagen
[MSG] file does not exist.	Datei existiert nicht
[MSG] has already been loaded	bereits geladen
[MSG] invalid project file.	unzulässige Projektdatei.
[MSG] no data entries in project file.	keine Dateneinträge in der Projektdatei.
[MSG] okay	erfolgreich
[PRM] Boolean	Wahrheitswert
[PRM] Choice	Auswahl
[PRM] Color	Farbe
[PRM] Colors	Farben
[PRM] Data Object	Datensatz
[PRM] Data Objects	Datensätze
[PRM] Degree	Grad
[PRM] File path	Dateipfad
[PRM] Floating point	Fließkommazahl
[PRM] Font	Schrift
[PRM] Frame Width [Pixels]	Rahmenbreite (Pixel)
[PRM] Grid	Raster
[PRM] Grid list	Liste von Rastern
[PRM] Grid system	Rastersystem
[PRM] Grids	Raster
[PRM] Integer	Ganzzahl
[PRM] Legend	Legende
[PRM] Long text	Langer Text
[PRM] Map Height [Pixels]	Kartenhöhen (Pixel)
[PRM] Map Width [Pixels]	Kartenbreite (Pixel)
[PRM] Node	Knoten
[PRM] Options	Optionen
[PRM] Parameter	
[PRM] Parameters	Parameterliste
[PRM] Point Cloud	Punktwolke
[PRM] Point Cloud list	Punktwolke auflisten
[PRM] Point Clouds	Punktwolken
[PRM] Save	Speichern
[PRM] Save Georeference (world file)	Georeferenz speichern
[PRM] Save KML file	KML-Datei speichern
[PRM] Shapes	Vektordaten
[PRM] Shapes list	Liste von Vektordaten
[PRM] Static table	Statische Tabelle
[PRM] TIN	
[PRM] TIN list	TIN Liste
[PRM] Table	Tabelle
[PRM] Table field	Tabellenfeld
[PRM] Table list	Liste von Tabellen
[PRM] Tables	Tabellen
[PRM] Text	
[PRM] Value range	Wertebereich
[PRM] Zoom	
[TXT] Close all data sets	Alle Datensätze schliessen
[TXT] Do you want to delete the selection?	Wollen Sie die Auswahl entfernen?
[TXT] Do you want to exit SAGA?	Wollen Sie SAGA beenden?
[TXT] No data loaded.	Keine Daten geladen.
[TXT] No description available	Keine Beschreibung verfügbar
[TXT] No parameters available.	Keine Parameter verfügbar
[TXT] SAGA\nSystem for Automated Geoscientific Analyses\nVersion 2.0	SAGA\nSystem für Automatisierte Geowissenschaftliche Analysen\nVersion 2.0
[TXT] This is not a text!	Dieses ist kein Text!
[TXT] grid system	Rastersystem
[TXT] grid systems	Rastersysteme
[VAL] B-Spline	
[VAL] Backward Diagonal	Schräg nach links
[VAL] Bicubic Spline	Bikubischer Spline
[VAL] Bilinear	
[VAL] Cross	Gekreuzt
[VAL] Cross Diagonal	Schräg gekreuzt
[VAL] Dot And Dash	Punkt und Strich
[VAL] Dotted	Gepunktet
[VAL] File Cache	Dateipuffer
[VAL] Forward Diagonal	Schräg nach rechts
[VAL] Graduated Color	Abgestufter Farbverlauf
[VAL] Horizontal	
[VAL] Inverse Distance	Umgekehrte Distanz
[VAL] Linear	
[VAL] Logarithmic (down)	Logarithmisch (nach rechts)
[VAL] Logarithmic (up)	Logarihmisch (nach links)
[VAL] Long Dashed	Lange Striche
[VAL] Lookup Table	Nachschlagetabelle
[VAL] Map Units	Karteneinheiten
[VAL] New	Neu
[VAL] No objects	Keine Objekte
[VAL] None	Nicht vorhanden
[VAL] Normal	
[VAL] Opaque	Undurchsichtig
[VAL] RGB	
[VAL] RGB Overlay	
[VAL] RTL Compression	RTL Komprimierung
[VAL] Screen	Bildschirm
[VAL] Shade	Schummerung
[VAL] Short Dashed	Kurze Striche
[VAL] Solid	Solide
[VAL] Transparent	
[VAL] Unique Symbol	Einheitliches Symbol
[VAL] Vertical	Vertikal
[VAL] [all grid systems]	[alle Rastersysteme]
[VAL] [create]	[erstellen]
[VAL] [default]	[Standardwert]
[VAL] [no choice available]	[keine Auswahl verfügbar]
[VAL] [no fields]	[keine Felder verfügbar]
[VAL] [none]	[nicht vorhanden]
[VAL] [not set]	[nicht gesetzt]
[VAL] no	nein
[VAL] no scaling	
[VAL] object	Objekt
[VAL] objects	Objekte
[VAL] ready	fertig
[VAL] scale to size range	
[VAL] yes	ja
[not set]|	
\n** Error : Invalid parameters **\n	
\nError: Please verify your xMin, yMin, xMax, yMax settings!\n	\nFehler: Bitte überprüfe deine xMin, yMin, xMax, yMax Einstellungen!\n
\nError: the method Extent by Grid(s) requires grid(s) as input!\n	\nFehler: Die Methode Ausdehnung durch Raster erfordert ein Raster als Eingabe!\n
\nError: the method Extent by Shape(s) requires shape(s) as input!\n	\nFehler: Die Methode Ausdehnung durch Vektoren erfordert eine Vektordatendatei als Eingabe!\n
\nNumber of Clusters	\nAnzahl der Gruppen
\nNumber of Variables	\nAnzahl der Variablen
\nRMS  of Residuals (stdfit):\t%f\n	\nQuadratwurzel der Reste (stdfit):\t%f\n
\nValue of Target Function	\nWert der Zielfunktion
\n\n ** Error : Could not close PDF engine ** \n\n	\n\n **Fehler: Konnte PDF-Modul nicht beenden **\n\n
\n\n ** Error : Could not save PDF file ** \n\n	\n\n **Fehler: Konnte PDF-Datei nicht speichern **\n\n
a + b * (1 - exp(-(x / c)^2))	
a + b * (1 - exp(-x / c))	
a + b / x	
a(q)	
a(q) [lower bound]	
a(q) [upper bound]	
a(s)	
a(s) [lower bound]	
a(s) [upper bound]	
abort export	
absolute	absolut
access violation	Fehlerhafter Speicherzugriff
additive	
after	nach
aggregating inside regions\n	
aggregating over all the grid\n	
all attributes	alle Attribute
all classes	alle Klassen
all directions	alle Richtungen
all entities	
all points	alle Punkte
all points in search radius	alle Punkte im Suchradius
all polygons	alle Polygone
all shapes	Alle Vektoren
analysing training areas	berechne Übungsfläche
another grid	andere Rasterdaten
append	Anhängen
append records, if table structure allows	
appending to existing table	
approximating points...	Punkte angleichend…
are in the specified directory.\n	
area	
arrow	
arrow (centered to cell)	
ascending	aufsteigend
attribute field	Attributfeld
author      	Autor
automatically save and load	automatisch speichern und laden
available module libraries	verfügbare Modulbibliotheken
available modules	verfügbare Module
average	Durchschnitt
b(q)	
b(q) [lower bound]	
b(q) [upper bound]	
ball	Ball
bar	Balken
bar (not outlined)	Balken (nicht umrandet)
before	vor
binary	binär
binary encoding	binäre Verschlüsselung
bit	
black > blue	schwarz > blau
black > green	schwarz > grün
black > red	schwarz > rot
black hat	
blue channel color	
bottom	Unten
bottom / left	
bright - dark	hell - dunkel
calculate averages	
calculate gradient magnitude	
calculate gradients	
calculating initial distances\n	
calculating splines...	Splines berechnend…
cannot execute interactive module	interaktives Modul kann nicht ausgeführt werden
cell area	
cells	
center	zentriert
center cell's aspect direcion	
central	zentral
change	Wechsel
character string	Zeichenkette
check this in case parameter 'water' is absolute water level	
check this in case seed cells are coded with absolute water level	
circle	Kreis
circle in rhombus	Kreis in Rhombus
circle in square	Kreis in Quadrat
circle in triangle (down)	Kreis in Dreieck (Spitze abwärts)
circle in triangle (up)	Kreis in Dreieck (Spitze aufwärts)
circle with rhombus	Kreis mit Rhombus
circle with square	Kreis mit Quadrat
circle with triangle (down)	Kreis mit Dreieck (Spitze abwärts)
circle with triangle (up)	Kreis mit Dreieck (Spitze aufwärts)
classification	
clay content	Tongehalt
clean up temporary data structures\n	
closing	
color	Farbe
color (rgb)	Farbe (RGB)
colors	Farben
columns	Spalten
comma	
comma (,)	
commit	
completely contained	vollkommen umschlossen
confirm	Bestätige
confirm with options	Bestätige mit Optionen
continue	fortsetzen
coordinates (offset, range, cell size, tile size)	
copyrights (c) 2006 Stefan Liersch	
corner	
could not commit/rollback transactions.	
could not connect ODBC source	
could not create geometry field	
could not create index: insufficient memory	Index konnte nicht erzeugt werden: nicht genügend Speicher
could not initialize point search engine	
could not open data source	
create data source	
create layer	
creating batch file example	erzeuge Batch-Datei als Beispiel
creating interpolator	erzeuge Interpolator
cross	
cyan - white	cyan - weiß
cylinder	Zylinder
dX	
dX (Map Units)	dX (Karteneinheiten)
dX(GridUnits)	dX(Vektoreinheiten)
dY	
dY (Map Units)	dY (Karteneinheiten)
dY(GridUnits)	dY(Vektoreinheiten)
dark - bright	dunkel - hell
database table does not exist	Datentabelle existiert nicht
date	Datum
date (dd.mm.yyyy)	Datum (dd.mm.yyyy)
day	
default	Standard
default (same brightness)	Standard (gleiche Helligkeit)
delete data source	
delete feature	
delete layer	
descending	absteigend
destriping1 filter for Grids	
destriping2 filter for values in a specified range (min-max)	
digital elevation model	
digital elevation model [m]	
digitzing a polygon	Digitalisiere ein Polygon
dilation	
direction of scan flag	
direction to the center cell	
directional components (A = x, B = y)	
directional1 average for Grids	
distance	
do not confirm	nicht bestätigen
do not show	nicht anzeigen
do not update	
down	
dragging a box	Zeichne einen Kasten
driver not found.	
dropping table	
duplicates have been identified.	Duplikate müssen erst identifiziert werden
e	
each island as separated polygon	jede Insel als abgetrenntes Polygon
edge of flight line flag	
elevation	
elevation and roughness	
ellipse	
empty	leer
empty coded function	leere Funktion
empty input list	leere Eingabeliste
empty or corrupted file	
enumeration	
erosion	
error	Fehler
exclude range	
executing module	Modulausführung
existing grid system	
exponential	
exponential weighting scheme	exponentiell gewichtetes Schema
extent of lake, coded with local water depth	
extent of lake, coded with water depth	
failed	fehlgeschlagen
failed to create index for grid	gescheitert beim Erstellen eines Index für Raster
failed to create index for table	gescheitert beim Erstellen eines Index für Tabelle
failed: could not find a suitable import driver	
feature space	
feature space and position	
field cannot be mapped to binary object	Feld kann nicht als binäres Objekt abgebildet werden
file could not be opened	
file could not be opened.	
file not found	
find local minima	
first	zu Erst
first order polynom	
first value	erster Wert
first value in order of grid list	erster Wert in Reihenfolge der Liste der Raster
fit to each grid	
fit to overall 1.5 standard deviation	
fit to overall 2.0 standard deviation	
fit to overall range	
fit to page	an Seite anpassen
fit to value	
fixed cell height	feste Zellenhöhe
fixed value	fester Wert
floating point	
flow width (original)	
function evaluations	
function fitting failed !	
function norm	
function not found	Funktion nicht gefunden
function table full	Funktionstabelle voll
fvec	
gaussian	
gaussian kernel	
gaussian weighting	
gaussian weighting scheme	gewichtetes Gaussches Schema
geographical	
gps-time	
gradient (degree)	
gradient (tangens)	
green > blue	grün > blau
green > grey > blue	grün > grau > blau
green > red > blue	grün > rot > blau
green channel color	
greyscale	Graustufen
grid	Raster
grid project	Rasterprojekt
grid system	
guam	
h	
height	
highest z	höchster z
horizontal	
if empty shapes layers's name is used as table name	
if less than 100, it is distinguished between interior and core forest	wenn weniger als 100, ist es kennzeichnend zwischen Innerem- und Kernwald
image	Bild
immediate	direkt
improper function syntax	unsachgemäße Funktionssyntax
incidence calculation	
include range	
index out of bounds	Index außerhalb der Regeln
initialising gradient...	
initialising planetary bending...	
initialization	
input	Eingabe
input file	Eingabedatei
instable (thawing)	
intensity	
interactive	interaktiv
interactive execution	interaktive Ausführung
interpolating	interpolierend
interpolating grid: 	interpoliere Raster:
intersects	Schnittmenge
invalid E00 file	
invalid control points	
invalid filter matrix	
invalid formula !	
invalid geographic coordinate system / datum	
invalid input	unzulässige Eingabe
invalid module libraries path	falscher Dateipfad zur Modulbibliothek
invalid number of parameters	unzulässige Zahl an Parametern
invalid or empty shapes layer	
invalid points have been skipped	
invalid utm zone	
inverse distance to a power	inverse Entfernung zu einem Schwerpunkt
inverse transformation not available	
is ignored if set to zero	wird nicht berücksichtigt wenn auf Null gesetzt
j-shaped	j-förmig
k factor	
keep original line attributes	
label minima	
last	zu Letzt
last opened	zuletzt geöffnet
last value	letzter Wert
least significant first	
left	links
level	Level
level 1	Level 1
level 2	Level 2
library name	Bibliotheksname
library path	Bibliothekspfad
line simplification can only be applied to lines and polygons	
linear	
linearly decreasing within search radius	mit dem Suchradius linear abnehmend
lines	
loading	
local time	
local water depth or absolute water level at the user specified cell	
localhost	
lowest z	niedrigster z
m	
m2	
m2/h	
magenta - white	magenta - weiß
mahalanobis distance	Mahalanobisentfernung
mark breaks in first line	
masking...	maskieren…
match input data	
mathematical	
max	
max. change	max. Wechsel
max_sd	
maxima	
maximum	
maximum likelihood	Maximale Wahrscheinlichkeit
maximum number of observations	
maximum number of points	maximale Anzahl der Punkte
maximum value	Maximalwert
maximum x value	maximaler x-Wert
maximum y value	maximaler y-Wert
mean	Mittel
mean value	Mittelwert
median|quartiles|deciles|5% interval|	Mittelwert|Viertel|zehntel|5 % Intervall|
merging grid	verschmelze Raster
min	
min < value < max	min < Wert < max
min < value <= max	min < Wert <= max
min <= value < max	min <= Wert < max
min <= value <= max	min <= Wert <= max
min_sd	
minima	
minima and maxima	
minimum	Minimum
minimum distance	Minimale Entfernung
minimum slope angle preserved from one cell to the next, zero results in flat areas [Degree]	
minimum value	Minimalwert
minimum x value	minimaler x-Wert
minimum y value	minimaler y-Wert
missing operand	fehlender Operand
module	Modul
module library	Modulbibliothek
module library not found	Modulbibliothek nicht gefunden
module name 	Modulname
module not found	Modul nicht gefunden
moment	
more than one field in selection	mehr als ein Feld ausgewählt
morpological gradient	
most significant first	
multi scale	
multiplicative	vielfach
n	
new	neu
new value	neuer Wert
no	nein
no 'get extents' support for single point layers	keine ´get extents´Unterstützung für Einzelpunkt-Vektorebenen
no attributes in table	keine Attribute in der Tabelle
no conversion (areas already given as specific catchment area)	
no data values	keine Datenwerte
no data values >> value	keine Datenwerte >> Wert
no database connection	Keine Datenbankverbindung
no description available	
no distance weighting	
no features to buffer.	keine Eigenschaften zum Puffern.
no fields in selection	Keine Felder in der Auswahl
no gaps	Keine Lücken.
no grid in list	
no histogram for unclassified data	kein Histogramm für unbestimmte Werte
no intersection with mask grid.	Keine Schnittmenge mit Maskierungsraster.
no layers in data source	
no memory	kein Speicher
no projection specified	
no projection type defined	
no search radius (global)	kein Suchradius (global)
no shapes for intersection found	
no target specified	
no translation available	
no valid module library found in path	keine gültige Modulbibliothek gefunden
no variation in point pattern	
nodes	
noise variance given as absolute value	Varianz des Rauschens gegeben als absoluter Wert
noise variance given relative to mean standard deviation	Varianz des Rauschens gegeben als Mittelwert der Standardabweichung
non-linear response term	
none	
nonlinear	
normal|down under|	
not enough neighbours	
not enough observations	
not enough points for interpolation	
not enough points to perform pattern analysis	
nothing to do: no data in selection	
number of cells in S-N direction	Anzahl der Zellen in S-N-Richtung
number of cells in W-E direction	Anzahl der Zellen in W-E-Richtung
number of dropped shapes	
number of grid cells per tile	
number of pits above threshold level	
number of points	
number of processed sinks	
number of returns of given pulse	
number of the return	
okay	
old value	alter Wert
one layer for all points	eine Ebene für alle Punkte
one multi-line per polygon	
one single (multi-)polygon object	ein einzelnes (multi-)polygon Objekt
one single class specified by class identifier	eine einzelne Klasse spezifiziert durch Klassenidentifizierer
only during start up phase	nur während der Programminitialisierung
only entities with layer definition	
only entities without layer definition	
only shapes with table entry	nur Vektoren mit Tabelleneinträgen
only z	nur z
open transactions committed	
open transactions rollbacked	
opening	
operator	Operator
optional	
optional input	optionale Eingabe
optional output	optionale Ausgabe
original calculation (Ringeler)	Originalberechnung (Ringeler)
original functions may not be deleted	Originalfunktion darf nicht entfernt werden
other	
other values	andere Werte
other values >> value	andere Werte >> Werte
output	Ausgabe
panorama	Panorama
parallel	
parallelepiped	Parallelepiped
parameters	Parameter
pass	Ablauf
pdf	
perform region growing	
performing distance calculation...	führe Enfernungsberechnung aus…
pie	Torte
pie (not outlined)	Torte (nicht umrandet)
plain	flach
point (.)	
point cloud	
point cloud (centered)	
point cloud viewer can only be run from graphical user interface	Punktwolkenbetrachter kann nur von der Grafischen Benutzeroberfläche gestartet werden
point cloud viewer will not be started, because point cloud has no points	Punktwolkenbetrachter kann nicht gestartet werden, weil Punktwolken keine Punkte beinhalten
point source ID	
points	
points have been imported with success	
points read	
points written	
polygons	Polygone
polygons with same attribute value	Polygone mit gleichem Attributwert
power of distance	
preparing distance calculation...	bereite Entfernungsberechnung vor…
press any key	Drücke eine beliebige Taste
processed DEM	
projection initialization failure	
quadrants	Quadrant
quartic kernel	
random read	
random write	
range of days	
raster	
ready	fertig
ready ...	
rectangle	
red > blue	rot > blau
red > blue > green	rot > blau > grün
red > green	rot > grün
red > green > blue	rot > grün > blau
red > grey > blue	rot > grau > blau
red > grey > green	rot > grau > grün
red channel color	
red=1, green=2, blue=this	rot=1, grün=2, blau=dieses
red=1, green=this, blue=2	rot=1, grün=dieses, blau=2
red=2, green=1, blue=this	rot=2, grün=1, blau=dieses
red=2, green=this, blue=1	rot=2, grün=dieses, blau=1
red=this, green=1, blue=2	rot=dieses, grün=1, blau=2
red=this, green=2, blue=1	rot=dieses, grün=2, blau=1
regression analysis	
relative	relativ
removing orphants\n	
renaming classes\n	
replace	ersetzen
replace existing table	
replacements	Austausch
resolution	
return	
rgb color	
rhombus	Rhombus
right	rechts
rollback	
root	
rotated	
roughness	
rows	Reihen
running classification	laufende Klassifizierung
same as input grid	
sand content	Sandgehalt
scan angle	
search radius (local)	Suchradius (lokal)
second input grid (B) needed to perform desired operation	
second order polynom	
sectors	
seed cells coded with local water depth or absolute water level, all other cells NoData	
segments identified	identifizierte Segmente
selected shapes	ausgewählte Vektoren
selected table contains no valid records	ausgewählte Tabelle enthält keine gültigen Datensätze
selected table does not have numeric attributes	ausgewählte Tabelle enthält keine numerischen Attribute
separate layer for each polygon	einzelne Ebene für jedes Polygon
sequential write	
shape in process	
shapes	Vektoren
shapes have been dropped	
shapes layer extent	Vektorebenen-Umfang
show direct insolation for each time step.	
shp files folder	Vektordaten-Verzeichnis
sigmoidal	
signed 1 byte integer	1 byte Ganzzahl mit Vorzeichen
signed 2 byte integer	2 byte Ganzzahl mit Vorzeichen
signed 4 byte integer	4 byte Ganzzahl mit Vorzeichen
signed 8 byte integer	8 byte Ganzzahl mit Vorzeichen
simple line	
sin(x*x + y*y)	
single|range|simple table|user supplied table|	einzeln|Bereich|einfache Tabelle|durch Nutzer bereitgestellte Tabelle|
slope (A) and aspect (B)	
slower but memory saving	
smoothed surface	
space	
specify fields with type	
spectral angle mapping	Spektralwinkelkartierung
spectral information divergence	Spektralinformation Abweichung
sql excution error	SQL Ausführungsfehler
square	Quadrat
square root (catchment length)	
stable	
standard	
standard deviation	
standard kernel 1	
standard kernel 2	
step	
string	Zeichenkette
surface (A)	
symmetric	
syntax error	Syntaxfehler
syntax error in formula at position	
syntax error, position	Syntaxfehler, Position
t	
table already exists	
table could not be opened.	
tabulator	
text	
theta	
thick	dick
thin	dünn
threshold slope	
time of sunrise/sunset is only calculated if time span is set to single day	
tolerance as absolute values	Toleranz als absoluter Wert
tomaschTool	
too few parameters	Zu wenige Parameter
too many constants	Zu wenige Konstanten
too many parameters	Zu viele Parameter
top	Oben
top / right	
top hat	
topographic correction	
triangle (down)	Dreieck (Spitze abwärts)
triangle (up)	Dreieck (Spitze aufwärts)
triangulating	trianguliert
trying to drop table	
type -h or --help for further information	für weitere Informationen -h oder -help eingeben
undeclared parameter	nicht bestimmter Parameter
undefined	undefiniert
unknown error: execution	unbekannter Fehler: Ausführung
unknown error: user break	unbekannter Fehler: Abbruch durch Anwender
unknown parameter	
unknown projection	
unknown type	unbekannter Typ
unkown	
unmatched parentheses	verzerrter Einschub
unsigned 1 byte integer	vorzeichenlose 1 byte Ganzzahl
unsigned 2 byte integer	vorzeichenlose 2 byte Ganzzahl
unsigned 4 byte integer	vorzeichenlose 4 byte Ganzzahl
unsigned 8 byte integer	vorzeichenlose 8 byte Ganzzahl
unsorted	unsortiert
until user closes it	bis Mausklick
up	
update, colour stretch for each time step	
update, fixed colour stretch	
user data	
user defined	nutzerdefiniert
user defined grid system	
user defined kernel	
user defined reference	
value at mouse position	Wert an Mausposition
variance	
variance (a)	
variance (b)	
vectorising class	Klassen vektorisieren
vertical	vertikal
w	
white - cyan	weiß - cyan
white - magenta	weiß - magenta
white - yellow	weiß - gelb
white > blue	weiß > blau
white > green	weiß > grün
white > red	weiß > rot
with B-spline refinement	mit B-Spline-Verfeinerung
without B-spline refinement	ohne B-Spline-Verfeinerung
x - Values	x - Werte
x Position	
xMax	
xMin	
xMin, yMin, NX, NY	
xMin, yMin, xMax, yMax	
xmax	
xmin	
y - Values	y - Werte
y Position	
yMax	
yMin	
yellow - white	gelb - weiß
yellow > blue	gelb > blau
yellow > green	gelb > grün
yellow > red	gelb > rot
yes	ja
ymax	
ymin	
z values	
{STATZONAL_NAME} Zonal Grid Statistics	
